"source","destinations","mention","quote","reply","weight","DateUpdate"
"Redit_es","aimplas",389,1,2,392,2021-11-15
"Redit_es","ainiatecnologia",214,0,0,214,2021-11-15
"Redit_es","ITC_ceramica",209,0,2,211,2021-11-15
"Redit_es","AIDIMME",209,0,0,209,2021-11-15
"Redit_es","ITI_TIC",209,0,0,209,2021-11-15
"Redit_es","aitex_es",200,0,0,200,2021-11-15
"TeximInfo","aimplas",95,0,95,190,2021-11-15
"Redit_es","itenergia",189,0,0,189,2021-11-15
"Redit_es","AIJU_Tecnologi",184,0,0,184,2021-11-15
"Redit_es","InescopTech",180,0,0,180,2021-11-15
"Redit_es","ibv_org",177,0,0,177,2021-11-15
"Redit_es","itene",175,0,0,175,2021-11-15
"Redit_es","Redit_es",124,0,0,124,2021-11-15
"izarotech","aimplas",63,0,27,90,2021-11-15
"FuturEnviro","aimplas",74,0,0,74,2021-11-15
"RevistaRETEMA","aimplas",60,0,0,60,2021-11-15
"aimplas","aimplas",50,0,8,58,2021-11-15
"Mundoplast","aimplas",57,0,0,57,2021-11-15
"Redit_es","GVAavi",56,0,0,56,2021-11-15
"Redit_es","GVAivace",53,0,2,55,2021-11-15
"Packnet_","aimplas",32,8,7,47,2021-11-15
"ForoQyS","aimplas",28,0,14,42,2021-11-15
"Redit_es","GVAinnova",39,0,0,39,2021-11-15
"expoquimia","aimplas",37,0,0,37,2021-11-15
"AEMAC_","aimplas",33,0,1,34,2021-11-15
"CentrosCex","aimplas",22,0,11,33,2021-11-15
"veredictas","CEPplast",32,0,1,33,2021-11-15
"UPLIFT_EU","aimplas",32,0,0,32,2021-11-15
"UPLIFT_EU","UPLIFT_EU",2,0,30,32,2021-11-15
"veredictas","aimplas",32,0,0,32,2021-11-15
"veredictas","ANARPLA",32,0,0,32,2021-11-15
"veredictas","ClubMktBcn",32,0,0,32,2021-11-15
"veredictas","Digicomexpo",32,0,0,32,2021-11-15
"veredictas","elpublicistacom",32,0,0,32,2021-11-15
"veredictas","Envaspres",32,0,0,32,2021-11-15
"veredictas","IPMARK",32,0,0,32,2021-11-15
"veredictas","itene",32,0,0,32,2021-11-15
"veredictas","RevistaInfopack",32,0,0,32,2021-11-15
"RPM_Plasticos","aimplas",31,0,0,31,2021-11-15
"UPLIFT_EU","Bioplastech",30,0,0,30,2021-11-15
"UPLIFT_EU","DTUtweet",30,0,0,30,2021-11-15
"UPLIFT_EU","es_aau",30,0,0,30,2021-11-15
"UPLIFT_EU","fz_juelich",30,0,0,30,2021-11-15
"UPLIFT_EU","LeibnizHKI",30,0,0,30,2021-11-15
"UPLIFT_EU","Lundsuni",30,0,0,30,2021-11-15
"UPLIFT_EU","mi_sustainable",30,0,0,30,2021-11-15
"UPLIFT_EU","RWTH",30,0,0,30,2021-11-15
"UPLIFT_EU","SustainableInnE",30,0,0,30,2021-11-15
"UPLIFT_EU","TECNARO_GmbH",30,0,0,30,2021-11-15
"UPLIFT_EU","ucdgaeltacht",30,0,0,30,2021-11-15
"UPLIFT_EU","Vestforbranding",30,0,0,30,2021-11-15
"veredictas","revistaide",30,0,0,30,2021-11-15
"veredictas","Tecnifood",30,0,0,30,2021-11-15
"EPPM_Magazine","aimplas",29,0,0,29,2021-11-15
"i_plastico","aimplas",28,0,0,28,2021-11-15
"ainiatecnologia","aimplas",27,0,0,27,2021-11-15
"GVAavi","aimplas",26,0,0,26,2021-11-15
"UPLIFT_EU","europatweets",26,0,0,26,2021-11-15
"PlasticFV","aimplas",21,0,4,25,2021-11-15
"UPLIFT_EU","EU_Commission",25,0,0,25,2021-11-15
"pharmamarket","aimplas",24,0,0,24,2021-11-15
"Tecnifood","aimplas",23,0,1,24,2021-11-15
"Equiplast","aimplas",23,0,0,23,2021-11-15
"revistaide","aimplas",18,0,5,23,2021-11-15
"ait_research","aimplas",20,0,1,21,2021-11-15
"ambientplastico","aimplas",19,0,2,21,2021-11-15
"ANAIP_es","aimplas",20,0,1,21,2021-11-15
"expoquimia","accio_cat",21,0,0,21,2021-11-15
"Alvaro_Eslu","aimplas",17,0,3,20,2021-11-15
"expoquimia","IREC_Energia",20,0,0,20,2021-11-15
"Fedit","aimplas",14,4,2,20,2021-11-15
"AvepAsociacion","aimplas",18,1,0,19,2021-11-15
"FuturEnviro","FuturEnviro",15,1,3,19,2021-11-15
"emprenemjunts","aimplas",18,0,0,18,2021-11-15
"ResiduosPro","aimplas",18,0,0,18,2021-11-15
"UPLIFT_EU","t_uppe",18,0,0,18,2021-11-15
"BIOVAL_es","aimplas",16,0,1,17,2021-11-15
"Regmurcialimpia","aimplas",15,0,2,17,2021-11-15
"davidorreta","aimplas",16,0,0,16,2021-11-15
"davidorreta","ResiduosPro",16,0,0,16,2021-11-15
"SustainPlastics","aimplas",16,0,0,16,2021-11-15
"aec_es","aimplas",13,1,0,14,2021-11-15
"ceeivalencia","aimplas",14,0,0,14,2021-11-15
"Eurosurfas","aimplas",14,0,0,14,2021-11-15
"int_quimica","aimplas",14,0,0,14,2021-11-15
"ITC_ceramica","aimplas",14,0,0,14,2021-11-15
"itenergia","GVAivace",14,0,0,14,2021-11-15
"ait_research","BioICEP_IMGGE",12,1,0,13,2021-11-15
"eurocarne","aimplas",11,0,2,13,2021-11-15
"itenergia","aimplas",13,0,0,13,2021-11-15
"OceanetsProject","aimplas",12,1,0,13,2021-11-15
"PlasticsEuropES","aimplas",13,0,0,13,2021-11-15
"AEMAC_","FIDAMC_",12,0,0,12,2021-11-15
"expoquimia","Leitat",12,0,0,12,2021-11-15
"Redit_es","valenciactiva_",12,0,0,12,2021-11-15
"ait_research","FournetMargaret",10,0,1,11,2021-11-15
"ibv_org","aimplas",11,0,0,11,2021-11-15
"Regmurcialimpia","Vertidos_Cero",9,0,2,11,2021-11-15
"somoscidec","aimplas",11,0,0,11,2021-11-15
"ait_research","ambercentre",10,0,0,10,2021-11-15
"ait_research","RDI_at_LIT",10,0,0,10,2021-11-15
"CdeCarnica","aimplas",10,0,0,10,2021-11-15
"CentrosCex","OceanetsProject",10,0,0,10,2021-11-15
"Cicloplast_com","aimplas",10,0,0,10,2021-11-15
"expoquimia","harvestoreEU",10,0,0,10,2021-11-15
"expoquimia","la_UPC",10,0,0,10,2021-11-15
"expoquimia","linknovate",10,0,0,10,2021-11-15
"expoquimia","RECOTRANS_H2020",10,0,0,10,2021-11-15
"GVAivace","aimplas",10,0,0,10,2021-11-15
"Hispackbcn","aimplas",10,0,0,10,2021-11-15
"iResiduo","aimplas",10,0,0,10,2021-11-15
"PLABUNsrl","aimplas",10,0,0,10,2021-11-15
"pteco2","aimplas",9,1,0,10,2021-11-15
"Vertidos_Cero","aimplas",10,0,0,10,2021-11-15
"AEMAC_","Eurecat_news",9,0,0,9,2021-11-15
"AvepAsociacion","ANAIP_es",9,0,0,9,2021-11-15
"AvepAsociacion","ANARPLA",9,0,0,9,2021-11-15
"AvepAsociacion","AvepAsociacion",9,0,0,9,2021-11-15
"AvepAsociacion","Cicloplast_com",9,0,0,9,2021-11-15
"CentrosCex","corifyAF",9,0,0,9,2021-11-15
"CentrosCex","Grupo_TSK",9,0,0,9,2021-11-15
"CentrosCex","Molecor",9,0,0,9,2021-11-15
"CentrosCex","PigCHAMP_Europa",9,0,0,9,2021-11-15
"CentrosCex","PlatinoEduca",9,0,0,9,2021-11-15
"CentrosCex","skrollerbelt",9,0,0,9,2021-11-15
"expoquimia","ICIQchem",9,0,0,9,2021-11-15
"fadiplastsl","aimplas",5,0,4,9,2021-11-15
"fruittoday","aimplas",9,0,0,9,2021-11-15
"GVAivace","Julia_company",9,0,0,9,2021-11-15
"GVAivace","Redit_es",9,0,0,9,2021-11-15
"int_envase","aimplas",9,0,0,9,2021-11-15
"MaripeSamper","skrollerbelt",8,0,1,9,2021-11-15
"RevistaMercados","aimplas",9,0,0,9,2021-11-15
"UPLIFT_EU","BioICEP_H2020",9,0,0,9,2021-11-15
"Vertidos_Cero","Vertidos_Cero",7,0,2,9,2021-11-15
"AEMAC_","aeroespacialUPM",8,0,0,8,2021-11-15
"anacanoarribas","CoopsAgroCV",6,0,2,8,2021-11-15
"AvepAsociacion","PlasticsEuropES",8,0,0,8,2021-11-15
"Equiplast","Leitat",8,0,0,8,2021-11-15
"esplasticos","aimplas",8,0,0,8,2021-11-15
"Eurosurfas","accio_cat",8,0,0,8,2021-11-15
"expoquimia","gremirecupera",8,0,0,8,2021-11-15
"expoquimia","LAB_Ecoinnova",8,0,0,8,2021-11-15
"expoquimia","Suruscircular",8,0,0,8,2021-11-15
"GVAivace","Rafa_Climentg",8,0,0,8,2021-11-15
"HABRILAN","AEMAC_",4,4,0,8,2021-11-15
"industry_arena","aimplas",8,0,0,8,2021-11-15
"ITC_ceramica","AIDIMME",8,0,0,8,2021-11-15
"ITC_ceramica","Redit_es",5,1,2,8,2021-11-15
"OceanetsProject","OceanetsProject",4,0,4,8,2021-11-15
"PlasticsWorld","aimplas",8,0,0,8,2021-11-15
"SagredoMarco","aimplas",8,0,0,8,2021-11-15
"silviaavilesg","aimplas",8,0,0,8,2021-11-15
"SusChemSpain","aimplas",8,0,0,8,2021-11-15
"SusChemSpain","deborahciencia",7,1,0,8,2021-11-15
"WaystupH2020","aimplas",8,0,0,8,2021-11-15
"_asobiocom","aimplas",7,0,0,7,2021-11-15
"ait_research","AitLibrary",7,0,0,7,2021-11-15
"Azmudeu","aimplas",7,0,0,7,2021-11-15
"Azmudeu","idainature",7,0,0,7,2021-11-15
"Azmudeu","tabitbilisim",7,0,0,7,2021-11-15
"BeonNAT_H2020","aimplas",6,0,1,7,2021-11-15
"ceeivalencia","ainiatecnologia",7,0,0,7,2021-11-15
"ceeivalencia","itenergia",7,0,0,7,2021-11-15
"Equiplast","accio_cat",7,0,0,7,2021-11-15
"Eurosurfas","IREC_Energia",7,0,0,7,2021-11-15
"GVAavi","Actecosl",7,0,0,7,2021-11-15
"GVAavi","realturfoficial",7,0,0,7,2021-11-15
"HABRILAN","aimplas",7,0,0,7,2021-11-15
"iambiente","aimplas",7,0,0,7,2021-11-15
"infoagrocom","aimplas",7,0,0,7,2021-11-15
"MaripeSamper","aimplas",7,0,0,7,2021-11-15
"OCRValencia","aimplas",7,0,0,7,2021-11-15
"OCRValencia","palbeme",7,0,0,7,2021-11-15
"OVTT","aimplas",7,0,0,7,2021-11-15
"RSM_es","aimplas",7,0,0,7,2021-11-15
"SusChemSpain","BASF_ES",7,0,0,7,2021-11-15
"SusChemSpain","Repsol",7,0,0,7,2021-11-15
"SusChemSpain","SABIC",7,0,0,7,2021-11-15
"UPLIFT_EU","MixUp_H2020",7,0,0,7,2021-11-15
"WaystupH2020","GVAivia",7,0,0,7,2021-11-15
"WaystupH2020","UA_Universidad",7,0,0,7,2021-11-15
"_asobiocom","CENER_Energia",6,0,0,6,2021-11-15
"aec_es","aec_es",1,0,5,6,2021-11-15
"AEMAC_","ImdeaMaterials",6,0,0,6,2021-11-15
"AErasmusproject","aimplas",6,0,0,6,2021-11-15
"ait_research","AIT__LIT",6,0,0,6,2021-11-15
"anacanoarribas","aimplas",6,0,0,6,2021-11-15
"Asefapi_Es","aimplas",6,0,0,6,2021-11-15
"CdeCarnica","ainiatecnologia",6,0,0,6,2021-11-15
"ceeivalencia","BIOVAL_es",6,0,0,6,2021-11-15
"ceeivalencia","GVAeconomia",6,0,0,6,2021-11-15
"ceeivalencia","itene",6,0,0,6,2021-11-15
"ClusterMAV","aimplas",6,0,0,6,2021-11-15
"Corresponsables","aimplas",6,0,0,6,2021-11-15
"CTplasUy","aimplas",6,0,0,6,2021-11-15
"DGreenblogger","aimplas",6,0,0,6,2021-11-15
"Equiplast","Cicloplast_com",6,0,0,6,2021-11-15
"Equiplast","IREC_Energia",6,0,0,6,2021-11-15
"escamilla50","GVAeconomia",3,0,3,6,2021-11-15
"escamilla50","skrollerbelt",4,0,2,6,2021-11-15
"expoquimia","Eurecat_news",6,0,0,6,2021-11-15
"FuturEnviro","Cicloplast_com",6,0,0,6,2021-11-15
"FuturEnviro","GVAavi",6,0,0,6,2021-11-15
"iambiente","ainiatecnologia",6,0,0,6,2021-11-15
"ibv_org","GVAivace",6,0,0,6,2021-11-15
"itenergia","itenergia",6,0,0,6,2021-11-15
"mafehegu","aimplas",3,0,3,6,2021-11-15
"MaripeSamper","Grupo_TSK",6,0,0,6,2021-11-15
"MaripeSamper","Molecor",6,0,0,6,2021-11-15
"MaripeSamper","PigCHAMP_Europa",6,0,0,6,2021-11-15
"MaripeSamper","PlatinoEduca",6,0,0,6,2021-11-15
"Mateprincs","aimplas",6,0,0,6,2021-11-15
"OCRValencia","Redit_es",6,0,0,6,2021-11-15
"OEPM_es","aimplas",6,0,0,6,2021-11-15
"parccientificuv","aimplas",6,0,0,6,2021-11-15
"PlasticsEuropES","ANAIP_es",6,0,0,6,2021-11-15
"PlasticsEuropES","ANARPLA",6,0,0,6,2021-11-15
"PlasticsEuropES","Cicloplast_com",6,0,0,6,2021-11-15
"Redit_es","OCRValencia",6,0,0,6,2021-11-15
"revista_PQ","aimplas",5,0,1,6,2021-11-15
"RevistaRETEMA","ecodes",6,0,0,6,2021-11-15
"RevistaRETEMA","INTE_UPC",6,0,0,6,2021-11-15
"RSM_es","ainiatecnologia",6,0,0,6,2021-11-15
"UPLIFT_EU","H2020demeto",6,0,0,6,2021-11-15
"Vertidos_Cero","uvigo",6,0,0,6,2021-11-15
"WaystupH2020","Biopolis_SL",6,0,0,6,2021-11-15
"WaystupH2020","BioSenseRS",6,0,0,6,2021-11-15
"WaystupH2020","fCIRCE",6,0,0,6,2021-11-15
"WaystupH2020","Novamont",6,0,0,6,2021-11-15
"WaystupH2020","SAV_lavega",6,0,0,6,2021-11-15
"WaystupH2020","Terra_i_Xufa",6,0,0,6,2021-11-15
"aec_es","AEDIVE",5,0,0,5,2021-11-15
"AEMAC_","amade_udg",5,0,0,5,2021-11-15
"AEMAC_","ferrerdalmaucm",5,0,0,5,2021-11-15
"AEMAC_","industry_arena",3,0,2,5,2021-11-15
"AEMAC_","tecnalia",5,0,0,5,2021-11-15
"AErasmusproject","euhospitals",5,0,0,5,2021-11-15
"AErasmusproject","HIHIreland",5,0,0,5,2021-11-15
"AErasmusproject","IDIVALdireccion",5,0,0,5,2021-11-15
"AErasmusproject","Jobsatskills",5,0,0,5,2021-11-15
"Agrimax_EU","aimplas",5,0,0,5,2021-11-15
"AgroNewsCV","aimplas",5,0,0,5,2021-11-15
"ait_research","AthloneIT",3,2,0,5,2021-11-15
"ait_research","AvecomNV",5,0,0,5,2021-11-15
"Azmudeu","Azmudeu",5,0,0,5,2021-11-15
"BeonNAT_H2020","BTU_CS",5,0,0,5,2021-11-15
"BeonNAT_H2020","CederCiemat",5,0,0,5,2021-11-15
"BeonNAT_H2020","FCesefor",5,0,0,5,2021-11-15
"BeonNAT_H2020","PEFCSpain",5,0,0,5,2021-11-15
"ceeivalencia","Biopolis_SL",5,0,0,5,2021-11-15
"ceeivalencia","CDTIoficial",5,0,0,5,2021-11-15
"ceeivalencia","iata_csic",5,0,0,5,2021-11-15
"disruptores_inn","aimplas",5,0,0,5,2021-11-15
"ECOTOX2","Vertidos_Cero",3,0,2,5,2021-11-15
"EFE_CValenciana","aimplas",5,0,0,5,2021-11-15
"emprenemjunts","itenergia",5,0,0,5,2021-11-15
"Equiplast","Eurecat_news",5,0,0,5,2021-11-15
"escamilla50","aimplas",5,0,0,5,2021-11-15
"escamilla50","CentrosCex",5,0,0,5,2021-11-15
"escamilla50","GVAivace",5,0,0,5,2021-11-15
"escamilla50","Julia_company",5,0,0,5,2021-11-15
"escamilla50","Rafa_Climentg",5,0,0,5,2021-11-15
"Eurosurfas","Eurecat_news",5,0,0,5,2021-11-15
"Eurosurfas","Leitat",5,0,0,5,2021-11-15
"expoquimia","AEMAC_",5,0,0,5,2021-11-15
"FCalidad","aimplas",4,0,1,5,2021-11-15
"Fedit","Redit_es",5,0,0,5,2021-11-15
"FEVEC_Valencia","aimplas",5,0,0,5,2021-11-15
"ffe_es","materplat",4,0,1,5,2021-11-15
"FuturEnviro","ainiatecnologia",5,0,0,5,2021-11-15
"FuturEnviro","Vertidos_Cero",5,0,0,5,2021-11-15
"GVAavi","GVAavi",5,0,0,5,2021-11-15
"GVAivace","CentrosCex",2,3,0,5,2021-11-15
"InterplastPT","aimplas",5,0,0,5,2021-11-15
"ITC_ceramica","GVAivace",5,0,0,5,2021-11-15
"ITI_TIC","aimplas",5,0,0,5,2021-11-15
"MaripeSamper","corifyAF",5,0,0,5,2021-11-15
"MartaEGMosquera","aimplas",5,0,0,5,2021-11-15
"MartaEGMosquera","inbiotecenlared",5,0,0,5,2021-11-15
"MartaEGMosquera","IQAR_UAH",5,0,0,5,2021-11-15
"MartaEGMosquera","UAHes",5,0,0,5,2021-11-15
"maytedomingo_","aimplas",5,0,0,5,2021-11-15
"maytedomingo_","ainiatecnologia",5,0,0,5,2021-11-15
"maytedomingo_","itenergia",5,0,0,5,2021-11-15
"maytedomingo_","ITI_TIC",5,0,0,5,2021-11-15
"maytedomingo_","Redit_es",5,0,0,5,2021-11-15
"Monviciano","EUGCC_cleanergy",3,0,2,5,2021-11-15
"Novamont_Iberia","aimplas",4,1,0,5,2021-11-15
"OCRValencia","Consum",5,0,0,5,2021-11-15
"OCRValencia","masapa1982",5,0,0,5,2021-11-15
"PackagingEurope","aimplas",5,0,0,5,2021-11-15
"parccientificuv","parccientificuv",0,0,5,5,2021-11-15
"plasticoshita","aimplas",4,0,1,5,2021-11-15
"PlasticsEuropES","AvepAsociacion",5,0,0,5,2021-11-15
"poscosecha","aimplas",5,0,0,5,2021-11-15
"pteco2","AgEInves",5,0,0,5,2021-11-15
"pteco2","incarCSIC",5,0,0,5,2021-11-15
"pteco2","tecnalia",5,0,0,5,2021-11-15
"pteco2","ualmeria",5,0,0,5,2021-11-15
"Regmurcialimpia","Ferfollos",3,0,2,5,2021-11-15
"RepetCoinnova","aimplas",4,1,0,5,2021-11-15
"somoscidec","Afi_es",5,0,0,5,2021-11-15
"somoscidec","ainiatecnologia",5,0,0,5,2021-11-15
"somoscidec","fCIRCE",5,0,0,5,2021-11-15
"somoscidec","ICTA_UAB",5,0,0,5,2021-11-15
"ter4bithi4","aimplas",5,0,0,5,2021-11-15
"Vertidos_Cero","ArviInnovapesca",5,0,0,5,2021-11-15
"Vertidos_Cero","OceanetsProject",4,0,1,5,2021-11-15
"WaystupH2020","biobean",5,0,0,5,2021-11-15
"WaystupH2020","imec_int",5,0,0,5,2021-11-15
"WaystupH2020","NAFIGATECorp",5,0,0,5,2021-11-15
"WaystupH2020","ntua",5,0,0,5,2021-11-15
"WaystupH2020","SustainableCTgr",5,0,0,5,2021-11-15
"Wendy_Moreno_EU","ai_eic",3,0,2,5,2021-11-15
"10t_proyectos","aimplas",4,0,0,4,2021-11-15
"aalbaperez","Redit_es",2,1,1,4,2021-11-15
"AdonaiHM","javiergarciamar",3,0,1,4,2021-11-15
"AdonaiHM","Redit_es",3,1,0,4,2021-11-15
"aec_es","AENOR",4,0,0,4,2021-11-15
"aec_es","AnfacAutomovil",4,0,0,4,2021-11-15
"aec_es","BoschEspana",4,0,0,4,2021-11-15
"aec_es","DeutzBS",4,0,0,4,2021-11-15
"aec_es","QualityCpa",4,0,0,4,2021-11-15
"AEMAC_","AEMAC_",0,1,3,4,2021-11-15
"AEMAC_","aernnova_usa",4,0,0,4,2021-11-15
"AEMAC_","Airbus",4,0,0,4,2021-11-15
"AEMAC_","AirbusHeli",4,0,0,4,2021-11-15
"AEMAC_","CalpeIT",4,0,0,4,2021-11-15
"AEMAC_","CentrosCex",2,0,2,4,2021-11-15
"AEMAC_","expoquimia",3,1,0,4,2021-11-15
"AEMAC_","IDEKO_",4,0,0,4,2021-11-15
"AEMAC_","TalgoGroup",4,0,0,4,2021-11-15
"AEMAC_","tsisl_oficial",4,0,0,4,2021-11-15
"AErasmusproject","AMRCtraining",4,0,0,4,2021-11-15
"AErasmusproject","Itemas",4,0,0,4,2021-11-15
"AErasmusproject","NUIGinnovation",4,0,0,4,2021-11-15
"AErasmusproject","sheffielduni",4,0,0,4,2021-11-15
"AgoraScience","aimplas",4,0,0,4,2021-11-15
"Agrimax_EU","BBI2020",4,0,0,4,2021-11-15
"Agrimax_EU","biconsortium",4,0,0,4,2021-11-15
"Agrimax_EU","EU_H2020",4,0,0,4,2021-11-15
"AgroNewsCV","ainiatecnologia",4,0,0,4,2021-11-15
"ai_eic","AristosInfo",3,0,1,4,2021-11-15
"ai_eic","H2020_Partner",3,0,1,4,2021-11-15
"ai_eic","Wendy_Moreno_EU",3,0,1,4,2021-11-15
"AIJU_Tecnologi","aimplas",4,0,0,4,2021-11-15
"aimplas","PackEuropeEli",2,0,2,4,2021-11-15
"aimplas","SustainableInnE",2,0,2,4,2021-11-15
"andresgilnogues","PlasticFV",2,1,1,4,2021-11-15
"AseTUB","aimplas",3,1,0,4,2021-11-15
"asociacionruvid","aimplas",4,0,0,4,2021-11-15
"Benihort","Benihort",2,0,2,4,2021-11-15
"BeonNAT_H2020","ContacticaInnov",4,0,0,4,2021-11-15
"BeonNAT_H2020","Envirohemp",4,0,0,4,2021-11-15
"BeonNAT_H2020","LeibnizATB",4,0,0,4,2021-11-15
"BeonNAT_H2020","NNFCC",4,0,0,4,2021-11-15
"BeonNAT_H2020","recordbioenergy",4,0,0,4,2021-11-15
"BIOVAL_es","ceeivalencia",4,0,0,4,2021-11-15
"BIOVAL_es","itenergia",4,0,0,4,2021-11-15
"botellas_eco","ResiduosPro",2,0,2,4,2021-11-15
"cdcampo1","aimplas",4,0,0,4,2021-11-15
"cdcampo1","CentrosCex",2,0,2,4,2021-11-15
"ceeivalencia","ceeivalencia",3,0,1,4,2021-11-15
"ceeivalencia","GVAivace",4,0,0,4,2021-11-15
"ceeivalencia","Redit_es",4,0,0,4,2021-11-15
"ceeivalencia","seimedcv",4,0,0,4,2021-11-15
"ClusterFPrint","aimplas",4,0,0,4,2021-11-15
"ClusterFPrint","PT3NEO",4,0,0,4,2021-11-15
"Consalud_es","aimplas",4,0,0,4,2021-11-15
"DominoPrint_ES","aimplas",4,0,0,4,2021-11-15
"DominoPrint_ES","RPM_Plasticos",2,0,2,4,2021-11-15
"Economia_3","aimplas",4,0,0,4,2021-11-15
"EcoxyProject","aimplas",3,0,1,4,2021-11-15
"elEconomistaCV","aimplas",4,0,0,4,2021-11-15
"emprenemjunts","BIOVAL_es",4,0,0,4,2021-11-15
"emprenemjunts","Cicloplast_com",4,0,0,4,2021-11-15
"Equiplast","AEMAC_",4,0,0,4,2021-11-15
"Equiplast","ANAIP_es",4,0,0,4,2021-11-15
"Equiplast","PlasticsEuropES",4,0,0,4,2021-11-15
"Equiplast","tecnalia",4,0,0,4,2021-11-15
"esplasticos","Cicloplast_com",4,0,0,4,2021-11-15
"eurocarne","ainiatecnologia",4,0,0,4,2021-11-15
"Eurosurfas","AEMAC_",4,0,0,4,2021-11-15
"Eurosurfas","linknovate",4,0,0,4,2021-11-15
"Eurosurfas","RECOTRANS_H2020",4,0,0,4,2021-11-15
"expoquimia","FIDAMC_",4,0,0,4,2021-11-15
"Fernando_Ca_63","SagredoMarco",2,0,2,4,2021-11-15
"ffe_es","ffe_es",4,0,0,4,2021-11-15
"ForoQyS","esplasticos",2,2,0,4,2021-11-15
"ForoQyS","SusChemSpain",2,2,0,4,2021-11-15
"Fund_Diversidad","aimplas",3,0,1,4,2021-11-15
"FuturEnviro","Afi_es",4,0,0,4,2021-11-15
"FuturEnviro","fCIRCE",4,0,0,4,2021-11-15
"FuturEnviro","GVAivace",4,0,0,4,2021-11-15
"FuturEnviro","ICTA_UAB",4,0,0,4,2021-11-15
"FuturEnviro","IDAEA_CSIC",4,0,0,4,2021-11-15
"FuturEnviro","PaisajeLimpio",4,0,0,4,2021-11-15
"garcia_saludes","Redit_es",3,0,1,4,2021-11-15
"GeriatricArea","aimplas",4,0,0,4,2021-11-15
"GeriatricArea","ibv_org",4,0,0,4,2021-11-15
"GVAavi","IISLaFe",3,1,0,4,2021-11-15
"GVAivace","GVAivace",4,0,0,4,2021-11-15
"Hispackbcn","ainiatecnologia",4,0,0,4,2021-11-15
"IBIAE","IBIAE",2,0,2,4,2021-11-15
"industry_arena","3Dnatives_ES",4,0,0,4,2021-11-15
"industry_arena","Leitat",4,0,0,4,2021-11-15
"industry_arena","tecnalia",4,0,0,4,2021-11-15
"IndustryTalksES","aimplas",3,0,1,4,2021-11-15
"InforetailNews","aimplas",4,0,0,4,2021-11-15
"int_reciclaje","aimplas",4,0,0,4,2021-11-15
"ITC_ceramica","ainiatecnologia",4,0,0,4,2021-11-15
"ITC_ceramica","ITI_TIC",4,0,0,4,2021-11-15
"jhomstor","edpemo",2,0,2,4,2021-11-15
"KimitecGroup","aimplas",4,0,0,4,2021-11-15
"KimitecGroup","BBI2020",2,2,0,4,2021-11-15
"KNAUFINDSPAIN","aimplas",4,0,0,4,2021-11-15
"LosPackaging","aimplas",2,0,2,4,2021-11-15
"MadresXClimaCan","Regmurcialimpia",2,0,2,4,2021-11-15
"marijosidemaya","deborahciencia",2,0,2,4,2021-11-15
"MartaEGMosquera","geqo_rseq",4,0,0,4,2021-11-15
"maytedomingo_","AIDIMME",4,0,0,4,2021-11-15
"MPN_Magazine","aimplas",3,0,1,4,2021-11-15
"OanaCaro","deborahciencia",2,0,2,4,2021-11-15
"OC_Composites","HABRILAN",2,0,2,4,2021-11-15
"OleoRevista","aimplas",4,0,0,4,2021-11-15
"olgainfoedita","aimplas",2,0,2,4,2021-11-15
"OVTTenglish","aimplas",4,0,0,4,2021-11-15
"Packnet_","ainiatecnologia",4,0,0,4,2021-11-15
"Packnet_","Cicloplast_com",4,0,0,4,2021-11-15
"PilotHarbour","AutPortValencia",2,0,2,4,2021-11-15
"PlasticsEuropES","deborahciencia",3,1,0,4,2021-11-15
"pteco2","FunditecOrg",4,0,0,4,2021-11-15
"Redit_es","EU_H2020",4,0,0,4,2021-11-15
"Redit_es","palbeme",4,0,0,4,2021-11-15
"Regmurcialimpia","Afi_es",4,0,0,4,2021-11-15
"Regmurcialimpia","ainiatecnologia",4,0,0,4,2021-11-15
"Regmurcialimpia","fCIRCE",4,0,0,4,2021-11-15
"Regmurcialimpia","ICTA_UAB",4,0,0,4,2021-11-15
"Regmurcialimpia","IDAEA_CSIC",4,0,0,4,2021-11-15
"Regmurcialimpia","PaisajeLimpio",4,0,0,4,2021-11-15
"Regmurcialimpia","somoscidec",4,0,0,4,2021-11-15
"RevistaRETEMA","Cicloplast_com",4,0,0,4,2021-11-15
"RPM_Plasticos","ainiatecnologia",4,0,0,4,2021-11-15
"SofiaRTD","aimplas",4,0,0,4,2021-11-15
"SOMM_alliance","ICTA_UAB",2,2,0,4,2021-11-15
"TeximInfo","ainiatecnologia",4,0,0,4,2021-11-15
"TRAKTECH_","aimplas",4,0,0,4,2021-11-15
"UPLIFT_EU","preserve_h2020",4,0,0,4,2021-11-15
"Vastuullisuus","aimplas",4,0,0,4,2021-11-15
"Vastuullisuus","Vastuullisuus",4,0,0,4,2021-11-15
"Vertidos_Cero","FBiodiversidad",4,0,0,4,2021-11-15
"Vesismin","aimplas",2,2,0,4,2021-11-15
"WaystupH2020","tuc_chania",4,0,0,4,2021-11-15
"3duardoFG","ter4bithi4",1,1,1,3,2021-11-15
"AbelardoDuran","aimplas",2,0,1,3,2021-11-15
"ADCV_com","Redit_es",2,0,1,3,2021-11-15
"aec_es","AECA_ITV",3,0,0,3,2021-11-15
"aec_es","AEI_Rioja_Auto",3,0,0,3,2021-11-15
"aec_es","ANAIP_es",3,0,0,3,2021-11-15
"aec_es","AutomotiveCie",3,0,0,3,2021-11-15
"aec_es","CAARAUTOARAGON",3,0,0,3,2021-11-15
"aec_es","cluster_facyl",3,0,0,3,2021-11-15
"aec_es","EurofirmsGroup",3,0,0,3,2021-11-15
"aec_es","Fundacion_FUNME",3,0,0,3,2021-11-15
"aec_es","gestamp_es",3,0,0,3,2021-11-15
"aec_es","MBenzEspana",3,0,0,3,2021-11-15
"aec_es","sernauto",3,0,0,3,2021-11-15
"aec_es","TessiGroupe_es",3,0,0,3,2021-11-15
"aec_es","TRIGO_TQN",3,0,0,3,2021-11-15
"AEMAC_","aimenct",3,0,0,3,2021-11-15
"AEMAC_","Applynano",3,0,0,3,2021-11-15
"AEMAC_","CDTIoficial",3,0,0,3,2021-11-15
"AEMAC_","CIDETEC_",3,0,0,3,2021-11-15
"AEMAC_","cimne",3,0,0,3,2021-11-15
"AEMAC_","Equiplast",3,0,0,3,2021-11-15
"AEMAC_","FagorAutomation",3,0,0,3,2021-11-15
"AEMAC_","HexcelCorp",3,0,0,3,2021-11-15
"AEMAC_","ictp_promocion",3,0,0,3,2021-11-15
"AEMAC_","IKERLANofficial",3,0,0,3,2021-11-15
"AEMAC_","Titania_aero",3,0,0,3,2021-11-15
"AEMAC_","ZiurComposites",3,0,0,3,2021-11-15
"AgoraScience","tecnalia",3,0,0,3,2021-11-15
"agrochemie","UPLIFT_EU",3,0,0,3,2021-11-15
"ai_eic","accio_cat",3,0,0,3,2021-11-15
"ai_eic","aimplas",3,0,0,3,2021-11-15
"ai_eic","biocat_cat",3,0,0,3,2021-11-15
"ai_eic","CDTIoficial",3,0,0,3,2021-11-15
"ai_eic","eencat",3,0,0,3,2021-11-15
"ai_eic","Eurecat_news",3,0,0,3,2021-11-15
"ai_eic","horizonexperts",3,0,0,3,2021-11-15
"ai_eic","IreneLarroy",3,0,0,3,2021-11-15
"ai_eic","itene",3,0,0,3,2021-11-15
"ai_eic","JCGarcia_CDTI",3,0,0,3,2021-11-15
"ai_eic","jordipietx",3,0,0,3,2021-11-15
"ai_eic","RosaAriasAlv",3,0,0,3,2021-11-15
"ai_eic","scibus",3,0,0,3,2021-11-15
"ai_eic","SorosGabinete",3,0,0,3,2021-11-15
"ai_eic","talk2much12",3,0,0,3,2021-11-15
"aimplas","InescopTech",3,0,0,3,2021-11-15
"ainiatecnologia","Nestle_es",3,0,0,3,2021-11-15
"ait_research","SergioFCeballos",2,1,0,3,2021-11-15
"Alvaro_Eslu","GVAivace",3,0,0,3,2021-11-15
"ANAIP_es","BASF_ES",3,0,0,3,2021-11-15
"ANAIP_es","Repsol",3,0,0,3,2021-11-15
"anape_eps","aimplas",3,0,0,3,2021-11-15
"anape_eps","Cicloplast_com",3,0,0,3,2021-11-15
"AperitivoSnacks","aimplas",3,0,0,3,2021-11-15
"AsocEyC","aimplas",3,0,0,3,2021-11-15
"AtfProfessional","aimplas",3,0,0,3,2021-11-15
"AutPortValencia","aimplas",3,0,0,3,2021-11-15
"Avia_automocion","aimplas",3,0,0,3,2021-11-15
"Baliht_EU","aimplas",3,0,0,3,2021-11-15
"BeonNAT_H2020","BBI2020",3,0,0,3,2021-11-15
"BeonNAT_H2020","BeonNAT_H2020",0,0,3,3,2021-11-15
"BeonNAT_H2020","USVro",3,0,0,3,2021-11-15
"BIOnTop_Project","aimplas",3,0,0,3,2021-11-15
"BIOnTop_Project","BIOnTop_Project",3,0,0,3,2021-11-15
"BIOVAL_es","ainiatecnologia",3,0,0,3,2021-11-15
"BIOVAL_es","InescopTech",3,0,0,3,2021-11-15
"ceeivalencia","ceei",3,0,0,3,2021-11-15
"ceeivalencia","emprenemjunts",3,0,0,3,2021-11-15
"Club_Excelencia","aimplas",3,0,0,3,2021-11-15
"ClusterFPrint","fenin_es",3,0,0,3,2021-11-15
"ClusterFPrint","NanomedSpain",3,0,0,3,2021-11-15
"COGITIValencia","aimplas",3,0,0,3,2021-11-15
"ColegioSalliver","Club_Excelencia",2,0,1,3,2021-11-15
"ColegioSalliver","GrupoSorollaEdu",2,0,1,3,2021-11-15
"compromisoclima","aimplas",2,0,1,3,2021-11-15
"CTplasUy","CTplasUy",2,1,0,3,2021-11-15
"ECAndalucia","aimplas",3,0,0,3,2021-11-15
"emprenemjunts","ainiatecnologia",3,0,0,3,2021-11-15
"Equiplast","FIDAMC_",3,0,0,3,2021-11-15
"Equiplast","harvestoreEU",3,0,0,3,2021-11-15
"Equiplast","ICIQchem",3,0,0,3,2021-11-15
"Equiplast","la_UPC",3,0,0,3,2021-11-15
"Equiplast","linknovate",3,0,0,3,2021-11-15
"Equiplast","RECOTRANS_H2020",3,0,0,3,2021-11-15
"escamilla50","JoseVilar3",3,0,0,3,2021-11-15
"escamilla50","RebecaOntinyent",3,0,0,3,2021-11-15
"escamilla50","Redit_es",3,0,0,3,2021-11-15
"escamilla50","Sebastia_Jordi",3,0,0,3,2021-11-15
"EUBioplastics","aimplas",3,0,0,3,2021-11-15
"Eurosurfas","FIDAMC_",3,0,0,3,2021-11-15
"Eurosurfas","harvestoreEU",3,0,0,3,2021-11-15
"Eurosurfas","ICIQchem",3,0,0,3,2021-11-15
"Eurosurfas","la_UPC",3,0,0,3,2021-11-15
"Fedit","InescopTech",3,0,0,3,2021-11-15
"Fedit","ITC_ceramica",3,0,0,3,2021-11-15
"feriaecofira","aimplas",3,0,0,3,2021-11-15
"ffe_es","aimplas",3,0,0,3,2021-11-15
"ffe_es","CIDETEC_",3,0,0,3,2021-11-15
"FlotantProject","aimplas",3,0,0,3,2021-11-15
"FlotantProject","plocan",3,0,0,3,2021-11-15
"FuturEnviro","ACCIONA",3,0,0,3,2021-11-15
"FuturEnviro","TOMRARecycling",3,0,0,3,2021-11-15
"GoHubTech","aimplas",3,0,0,3,2021-11-15
"Grupo_Soledad","istobal_es",2,0,1,3,2021-11-15
"GVAavi","Benihort",3,0,0,3,2021-11-15
"GVAavi","Betelgeux_es",3,0,0,3,2021-11-15
"GVAavi","IBMCP",3,0,0,3,2021-11-15
"GVAavi","ITC_Packaging",3,0,0,3,2021-11-15
"GVAavi","ITQ_UPVCSIC",3,0,0,3,2021-11-15
"GVAavi","UPV",3,0,0,3,2021-11-15
"GVAavi","UV_EG",3,0,0,3,2021-11-15
"GVAivace","AIDIMME",3,0,0,3,2021-11-15
"HABRILAN","AdvanFactories",2,0,1,3,2021-11-15
"HABRILAN","FIDAMC_",3,0,0,3,2021-11-15
"HABRILAN","OC_Composites",2,0,1,3,2021-11-15
"HABRILAN","Redit_es",3,0,0,3,2021-11-15
"i_alimentacion","aimplas",3,0,0,3,2021-11-15
"IBIAE","aimplas",3,0,0,3,2021-11-15
"ibv_org","HGUVALENCIA",3,0,0,3,2021-11-15
"ibv_org","ibv_org",3,0,0,3,2021-11-15
"ibv_org","IRTIC_UV",3,0,0,3,2021-11-15
"IDG_tv","UNESID",2,0,1,3,2021-11-15
"iiama_upv","aimplas",3,0,0,3,2021-11-15
"iiama_upv","GlobalOmnium",3,0,0,3,2021-11-15
"iiama_upv","Grupo_CALAGUA",3,0,0,3,2021-11-15
"industry_arena","AEMAC_",3,0,0,3,2021-11-15
"industry_arena","ENCS_CyberSec",3,0,0,3,2021-11-15
"industry_arena","Eurecat_news",3,0,0,3,2021-11-15
"industry_arena","festo_global",3,0,0,3,2021-11-15
"industry_arena","HispaRob",3,0,0,3,2021-11-15
"industry_arena","HP",3,0,0,3,2021-11-15
"industry_arena","IAM3DHUB",3,0,0,3,2021-11-15
"industry_arena","interempresas",3,0,0,3,2021-11-15
"industry_arena","MundoEmpresas",3,0,0,3,2021-11-15
"industry_arena","NAutomatizacion",3,0,0,3,2021-11-15
"industry_arena","SECARTYS",3,0,0,3,2021-11-15
"IndustryTalksES","IndustryTalksES",3,0,0,3,2021-11-15
"innotransfer","aimplas",3,0,0,3,2021-11-15
"innotransfer","espaitec",3,0,0,3,2021-11-15
"int_automocio","aimplas",3,0,0,3,2021-11-15
"ITC_ceramica","AIJU_Tecnologi",3,0,0,3,2021-11-15
"ITC_ceramica","aitex_es",3,0,0,3,2021-11-15
"ITC_ceramica","ibv_org",3,0,0,3,2021-11-15
"ITC_ceramica","InescopTech",3,0,0,3,2021-11-15
"ITC_ceramica","itene",3,0,0,3,2021-11-15
"ITC_ceramica","itenergia",3,0,0,3,2021-11-15
"izarotech","ANARPLA",3,0,0,3,2021-11-15
"izarotech","Cicloplast_com",3,0,0,3,2021-11-15
"izarotech","GVAivace",3,0,0,3,2021-11-15
"jealvarez","aimplas",3,0,0,3,2021-11-15
"MartaEGMosquera","lualnu10",2,1,0,3,2021-11-15
"Mateprincs","Mateprincs",1,0,2,3,2021-11-15
"materplat","ffe_es",2,0,1,3,2021-11-15
"maytedomingo_","ibv_org",3,0,0,3,2021-11-15
"maytedomingo_","ITC_ceramica",3,0,0,3,2021-11-15
"maytedomingo_","itene",3,0,0,3,2021-11-15
"maytedomingo_","valenciaplaza",3,0,0,3,2021-11-15
"Monviciano","aimplas",3,0,0,3,2021-11-15
"NagrifoodClust","aimplas",3,0,0,3,2021-11-15
"NagrifoodClust","itene",3,0,0,3,2021-11-15
"NagrifoodClust","unav",3,0,0,3,2021-11-15
"NagrifoodClust","UNavarra",3,0,0,3,2021-11-15
"NagrifoodClust","Zabala_IC",3,0,0,3,2021-11-15
"NontoxProject","NontoxProject",2,0,1,3,2021-11-15
"OceanetsProject","ArviInnovapesca",3,0,0,3,2021-11-15
"OceanetsProject","ecoalf",3,0,0,3,2021-11-15
"OceanetsProject","EU_MARE",3,0,0,3,2021-11-15
"OceanetsProject","Vertidos_Cero",3,0,0,3,2021-11-15
"Packnet_","Alimarket",3,0,0,3,2021-11-15
"Packnet_","Food4LifeSPAIN",3,0,0,3,2021-11-15
"Packnet_","Sealed_Air",3,0,0,3,2021-11-15
"Packnet_","UABBarcelona",3,0,0,3,2021-11-15
"pharmamarket","IISLaFe",3,0,0,3,2021-11-15
"Plastico_Indl","aimplas",3,0,0,3,2021-11-15
"PlasticsEuropES","BASF_ES",3,0,0,3,2021-11-15
"PlasticsEuropES","Repsol",3,0,0,3,2021-11-15
"PlasticsEuropES","SABIC",3,0,0,3,2021-11-15
"poscosecha","ainiatecnologia",3,0,0,3,2021-11-15
"preserve_h2020","aimplas",2,1,0,3,2021-11-15
"pteco2","pteco2",1,2,0,3,2021-11-15
"recosol_pr","aimplas",3,0,0,3,2021-11-15
"Redit_es","masapa1982",3,0,0,3,2021-11-15
"Redit_es","valenciaplaza",3,0,0,3,2021-11-15
"Regmurcialimpia","AEMArm",3,0,0,3,2021-11-15
"REMADYL_EU","EU_EASME",2,0,1,3,2021-11-15
"revistaide","Cicloplast_com",3,0,0,3,2021-11-15
"revistaimcb","aimplas",2,0,1,3,2021-11-15
"RevistaMercados","ainiatecnologia",3,0,0,3,2021-11-15
"RevistaOlimerca","aimplas",2,0,1,3,2021-11-15
"SagredoMarco","entidadPTV",3,0,0,3,2021-11-15
"SanchisFederico","aimplas",3,0,0,3,2021-11-15
"somoscidec","PaisajeLimpio",3,0,0,3,2021-11-15
"SusanaPBadal","MAmbienteBP_UJI",2,0,1,3,2021-11-15
"SusChemSpain","PlasticsEuropES",3,0,0,3,2021-11-15
"SustainPlastics","TNO_Research",3,0,0,3,2021-11-15
"Tecnifood","AvepAsociacion",3,0,0,3,2021-11-15
"Tecnifood","GVAavi",3,0,0,3,2021-11-15
"ter4bithi4","ANAIP_es",3,0,0,3,2021-11-15
"ter4bithi4","Cicloplast_com",3,0,0,3,2021-11-15
"ter4bithi4","esplasticos",3,0,0,3,2021-11-15
"ter4bithi4","PlasticsEuropES",3,0,0,3,2021-11-15
"veredictas","alzamoragroup",3,0,0,3,2021-11-15
"veredictas","Crisiscreativa",3,0,0,3,2021-11-15
"veredictas","irubistudio",3,0,0,3,2021-11-15
"Vertidos_Cero","ECOTOX2",2,0,1,3,2021-11-15
"WaystupH2020","BIOCAR_CIEMAT",3,0,0,3,2021-11-15
"WaystupH2020","DraxisEnv",3,0,0,3,2021-11-15
"WaystupH2020","WaystupH2020",3,0,0,3,2021-11-15
"WomenInPlastic","aimplas",3,0,0,3,2021-11-15
"3Recycler","RevistaAlimenta",1,0,1,2,2021-11-15
"88Harleen","aimplas",1,0,1,2,2021-11-15
"aalbaperez","AIJU_Tecnologi",2,0,0,2,2021-11-15
"aalbaperez","aimplas",2,0,0,2,2021-11-15
"aalbaperez","ainiatecnologia",2,0,0,2,2021-11-15
"aalbaperez","aitex_es",2,0,0,2,2021-11-15
"aalbaperez","ibv_org",2,0,0,2,2021-11-15
"aalbaperez","InescopTech",2,0,0,2,2021-11-15
"aalbaperez","ITC_ceramica",2,0,0,2,2021-11-15
"aalbaperez","itene",2,0,0,2,2021-11-15
"aalbaperez","ITI_TIC",2,0,0,2,2021-11-15
"AbelardoDuran","AbelardoDuran",0,2,0,2,2021-11-15
"acanocoloma","skrollerbelt",1,0,1,2,2021-11-15
"actualidadaero","aimplas",1,0,1,2,2021-11-15
"AdonaiHM","AIDIMME",2,0,0,2,2021-11-15
"AdonaiHM","AIJU_Tecnologi",2,0,0,2,2021-11-15
"AdonaiHM","aimplas",2,0,0,2,2021-11-15
"AdonaiHM","ainiatecnologia",2,0,0,2,2021-11-15
"AdonaiHM","aitex_es",2,0,0,2,2021-11-15
"AdonaiHM","Fedit",2,0,0,2,2021-11-15
"AdonaiHM","InescopTech",2,0,0,2,2021-11-15
"AdonaiHM","itenergia",2,0,0,2,2021-11-15
"AdvanFactories","aimplas",2,0,0,2,2021-11-15
"aec_es","AIN_Navarra",2,0,0,2,2021-11-15
"aec_es","Antolin_Oficial",2,0,0,2,2021-11-15
"aec_es","FCalidad",2,0,0,2,2021-11-15
"aec_es","GanvamOficial",2,0,0,2,2021-11-15
"aec_es","Gonvarri",2,0,0,2,2021-11-15
"aec_es","PolyWorks",2,0,0,2,2021-11-15
"AEMAC_","3Dnatives_ES",2,0,0,2,2021-11-15
"AEMAC_","AEBALL_UPMBALL",2,0,0,2,2021-11-15
"AEMAC_","AerAutomation",2,0,0,2,2021-11-15
"AEMAC_","aiasasociacion",2,0,0,2,2021-11-15
"AEMAC_","CEPplast",2,0,0,2,2021-11-15
"AEMAC_","CIDESIMX",2,0,0,2,2021-11-15
"AEMAC_","ClusterCICAT",2,0,0,2,2021-11-15
"AEMAC_","DANOBATGROUP",2,0,0,2,2021-11-15
"AEMAC_","DanobatSheetMet",2,0,0,2,2021-11-15
"AEMAC_","Eurosurfas",2,0,0,2,2021-11-15
"AEMAC_","GAIKER_BRTA",2,0,0,2,2021-11-15
"AEMAC_","GrupoOlmar",2,0,0,2,2021-11-15
"AEMAC_","HispaRob",2,0,0,2,2021-11-15
"AEMAC_","innovallcluster",2,0,0,2,2021-11-15
"AEMAC_","int_aeronautica",1,1,0,2,2021-11-15
"AEMAC_","mincoturgob",2,0,0,2,2021-11-15
"AEMAC_","OceanetsProject",2,0,0,2,2021-11-15
"AEMAC_","RECOTRANS_H2020",1,0,1,2,2021-11-15
"AEMAC_","SECARTYS",2,0,0,2,2021-11-15
"AEMAC_","testia",2,0,0,2,2021-11-15
"AEMAC_","tknika",2,0,0,2,2021-11-15
"AEMAC_","upvehu",2,0,0,2,2021-11-15
"AEMAC_","urjc",2,0,0,2,2021-11-15
"AErasmusproject","eu_tender",2,0,0,2,2021-11-15
"AErasmusproject","NUIGalwayMed",2,0,0,2,2021-11-15
"agapi_comunica","PlatinoEduca",1,0,1,2,2021-11-15
"AgoraScience","ANARPLA",1,0,1,2,2021-11-15
"AgoraScience","Cicloplast_com",2,0,0,2,2021-11-15
"AgoraScience","DaleVida_Plaas",1,1,0,2,2021-11-15
"AgoraScience","Leitat",2,0,0,2,2021-11-15
"agrochemie","acibGmbH",2,0,0,2,2021-11-15
"agrochemie","aimplas",2,0,0,2,2021-11-15
"agrochemie","Bioplastech",2,0,0,2,2021-11-15
"agrochemie","EU_H2020",2,0,0,2,2021-11-15
"agrochemie","fz_juelich",2,0,0,2,2021-11-15
"agrochemie","LeibnizHKI",2,0,0,2,2021-11-15
"agrochemie","RWTH",2,0,0,2,2021-11-15
"agrochemie","SustainableInnE",2,0,0,2,2021-11-15
"agrochemie","TECNARO_GmbH",2,0,0,2,2021-11-15
"agrochemie","ucddublin",2,0,0,2,2021-11-15
"AIJU_Tecnologi","GVAlabora",2,0,0,2,2021-11-15
"AIJU_Tecnologi","manudbto",1,0,1,2,2021-11-15
"AIJU_Tecnologi","RachelRock2",1,0,1,2,2021-11-15
"AIJU_Tecnologi","Redit_es",1,0,1,2,2021-11-15
"aimplas","3Dnatives_ES",2,0,0,2,2021-11-15
"aimplas","aec_es",2,0,0,2,2021-11-15
"aimplas","esplasticos",1,0,1,2,2021-11-15
"aimplas","GVAivace",2,0,0,2,2021-11-15
"aimplas","IndustrialesCV",1,0,1,2,2021-11-15
"aimplas","PackagingEurope",2,0,0,2,2021-11-15
"aimplas","ReportsMarkets",2,0,0,2,2021-11-15
"aimplas","universitatURV",2,0,0,2,2021-11-15
"aimplas","UPV",1,0,1,2,2021-11-15
"aimplas","urjc",2,0,0,2,2021-11-15
"ainiatecnologia","ANAIP_es",2,0,0,2,2021-11-15
"ainiatecnologia","ANARPLA",2,0,0,2,2021-11-15
"ainiatecnologia","iambiente",2,0,0,2,2021-11-15
"ainiatecnologia","Tecnifood",2,0,0,2,2021-11-15
"AIPIAcongress","3dclickclick",2,0,0,2,2021-11-15
"AIPIAcongress","AbbottGlobal",2,0,0,2,2021-11-15
"AIPIAcongress","Abigail__Dixon",2,0,0,2,2021-11-15
"AIPIAcongress","Accenture",2,0,0,2,2021-11-15
"AIPIAcongress","Advanced_TT",2,0,0,2,2021-11-15
"AIPIAcongress","AgriFoodX",2,0,0,2,2021-11-15
"AIPIAcongress","aimplas",2,0,0,2,2021-11-15
"ait_research","BioengPT",2,0,0,2,2021-11-15
"ait_research","BioICEP_H2020",2,0,0,2,2021-11-15
"ait_research","chemengntua",2,0,0,2,2021-11-15
"ait_research","EU_Commission",2,0,0,2,2021-11-15
"ait_research","LimerickIT",2,0,0,2,2021-11-15
"ait_research","MRI_AthloneIT",2,0,0,2,2021-11-15
"ait_research","tcddublin",2,0,0,2,2021-11-15
"ALBAsynchrotron","khaqanshati",1,0,1,2,2021-11-15
"alcaide_mkt","PactoMundial",1,0,1,2,2021-11-15
"Alvaro_Eslu","ainiatecnologia",2,0,0,2,2021-11-15
"Alvaro_Eslu","CDTIoficial",2,0,0,2,2021-11-15
"Alvaro_Eslu","GVAavi",2,0,0,2,2021-11-15
"Alvaro_Eslu","IDAEA_CSIC",2,0,0,2,2021-11-15
"Alvaro_Eslu","ITC_ceramica",1,0,1,2,2021-11-15
"Alvaro_Eslu","mincoturgob",2,0,0,2,2021-11-15
"Alvaro_Eslu","sost_cdti",2,0,0,2,2021-11-15
"Amgarve","aimplas",1,0,1,2,2021-11-15
"anacanoarribas","Benihort",2,0,0,2,2021-11-15
"anacanoarribas","IBMCP",2,0,0,2,2021-11-15
"ANAIP_es","_asobiocom",1,0,1,2,2021-11-15
"ANAIP_es","CEIS_spain",2,0,0,2,2021-11-15
"ANAIP_es","Cicloplast_com",2,0,0,2,2021-11-15
"ANAIP_es","DANOSA_SPAIN",2,0,0,2,2021-11-15
"ANAIP_es","PlasticsEuropES",1,0,1,2,2021-11-15
"ANAIP_es","RecicladosLaRed",2,0,0,2,2021-11-15
"ANAIP_es","SABIC",2,0,0,2,2021-11-15
"anape_eps","esplasticos",1,0,1,2,2021-11-15
"AndreaCasoF","Redit_es",1,0,1,2,2021-11-15
"andresgilnogues","aimplas",2,0,0,2,2021-11-15
"andresgilnogues","AvepAsociacion",2,0,0,2,2021-11-15
"andresgilnogues","Feria_Valencia",2,0,0,2,2021-11-15
"AnjanaLeon","CentrosCex",1,0,1,2,2021-11-15
"AnsiaDe","aimplas",2,0,0,2,2021-11-15
"AnsiaDe","ANAIP_es",1,0,1,2,2021-11-15
"AnsiaDe","asegre01",1,0,1,2,2021-11-15
"apk_ag","PlasticsEurope",1,1,0,2,2021-11-15
"apuntnoticies","aimplas",2,0,0,2,2021-11-15
"AristosInfo","ai_eic",1,0,1,2,2021-11-15
"Arturolarena","aimplas",2,0,0,2,2021-11-15
"Arturolarena","ainiatecnologia",2,0,0,2,2021-11-15
"Arturolarena","FGlobalNature",2,0,0,2,2021-11-15
"AseTUB","AseTUB",2,0,0,2,2021-11-15
"Asturicae","MartaEGMosquera",1,0,1,2,2021-11-15
"atmbiopro","UNLOCK_BBI",1,0,1,2,2021-11-15
"automatica_","aimplas",2,0,0,2,2021-11-15
"AVEmpresarios","garcia_saludes",2,0,0,2,2021-11-15
"AVEmpresarios","Redit_es",1,0,1,2,2021-11-15
"Baliht_EU","inea_eu",1,1,0,2,2021-11-15
"Bel21108685","aimplas",1,0,1,2,2021-11-15
"Benihort","aimplas",2,0,0,2,2021-11-15
"Benihort","IBMCP",2,0,0,2,2021-11-15
"BeonNAT_H2020","ipbraganca",2,0,0,2,2021-11-15
"BIOnTop_Project","EUBioplastics",1,1,0,2,2021-11-15
"bioplasticsmag","aimplas",2,0,0,2,2021-11-15
"BioSenseRS","WaystupH2020",1,1,0,2,2021-11-15
"BiotechAndrew","aimplas",2,0,0,2,2021-11-15
"BIOVAL_es","AIDIMME",2,0,0,2,2021-11-15
"BIOVAL_es","Biopolis_SL",2,0,0,2,2021-11-15
"BIOVAL_es","CDTIoficial",2,0,0,2,2021-11-15
"BIOVAL_es","GVAeconomia",2,0,0,2,2021-11-15
"BIOVAL_es","GVAivace",2,0,0,2,2021-11-15
"BIOVAL_es","iata_csic",2,0,0,2,2021-11-15
"BIOVAL_es","itene",2,0,0,2,2021-11-15
"BIOVAL_es","Redit_es",2,0,0,2,2021-11-15
"BIOVAL_es","seimedcv",2,0,0,2,2021-11-15
"BioVale_Cluster","Agrimax_EU",1,0,1,2,2021-11-15
"BlueMedEU","aimplas",2,0,0,2,2021-11-15
"BlueMedEU","azti_brta",2,0,0,2,2021-11-15
"BlueMedEU","BlueMedEU",0,0,2,2,2021-11-15
"BlueMedEU","CiimarUp",2,0,0,2,2021-11-15
"botellas_eco","aimplas",2,0,0,2,2021-11-15
"cabocla2001","Feique_ES",1,0,1,2,2021-11-15
"carlosgarcia_85","ainiatecnologia",1,1,0,2,2021-11-15
"cdcampo1","OceanetsProject",2,0,0,2,2021-11-15
"CdeCarnica","Salvy_FoToLoSaL",1,0,1,2,2021-11-15
"CdeCarnica","vayavacacom",2,0,0,2,2021-11-15
"CDTIoficial","aimplas",2,0,0,2,2021-11-15
"ceeivalencia","AIDIMME",2,0,0,2,2021-11-15
"ceeivalencia","aitex_es",2,0,0,2,2021-11-15
"ceeivalencia","InescopTech",2,0,0,2,2021-11-15
"CEPplast","aimplas",2,0,0,2,2021-11-15
"CEPplast","industry_arena",1,0,1,2,2021-11-15
"CEPplast","veredictas",1,0,1,2,2021-11-15
"CetecCentro","ainiatecnologia",1,1,0,2,2021-11-15
"Cicloplast_com","ANARPLA",2,0,0,2,2021-11-15
"Cicloplast_com","AvepAsociacion",2,0,0,2,2021-11-15
"Cicloplast_com","Cicloplast_com",0,0,2,2,2021-11-15
"Cicloplast_com","esplasticos",0,2,0,2,2021-11-15
"Cicloplast_com","PlasticsEuropES",2,0,0,2,2021-11-15
"cinea_eu","aimplas",2,0,0,2,2021-11-15
"cinea_eu","OceanetsProject",2,0,0,2,2021-11-15
"CircolarMenteNS","aimplas",2,0,0,2,2021-11-15
"ClusterFPrint","Rev_Pressgraph",1,1,0,2,2021-11-15
"COEXPAN_","aimplas",2,0,0,2,2021-11-15
"ColegioSalliver","aimplas",2,0,0,2,2021-11-15
"CompositesSpain","aimplas",2,0,0,2,2021-11-15
"CompositesSpain","CompositesSpain",2,0,0,2,2021-11-15
"CompositesSpain","MetalMadridEs",2,0,0,2,2021-11-15
"CosmeticLatam","aimplas",2,0,0,2,2021-11-15
"Crowdhelix","aimplas",2,0,0,2,2021-11-15
"CticCita","Cajamar",1,1,0,2,2021-11-15
"DarwinBioprosp","aimplas",2,0,0,2,2021-11-15
"Daype98","aimplas",2,0,0,2,2021-11-15
"deborahciencia","PilMontana",1,0,1,2,2021-11-15
"DGreenblogger","DGreenblogger",0,0,2,2,2021-11-15
"DGreenblogger","PERCAL_Project",2,0,0,2,2021-11-15
"DisenoCiudad","aimplas",2,0,0,2,2021-11-15
"disruptores_inn","Javarnau",2,0,0,2,2021-11-15
"disruptores_inn","UV_EG",2,0,0,2,2021-11-15
"DominoPrint_ES","Mundoplast",1,0,1,2,2021-11-15
"DominoPrint_ES","RevistaInfopack",1,0,1,2,2021-11-15
"DominoPrint_Mx","aimplas",1,0,1,2,2021-11-15
"DriadeSM","expoquimia",1,0,1,2,2021-11-15
"DriadeSM","gremirecupera",2,0,0,2,2021-11-15
"DriadeSM","LAB_Ecoinnova",2,0,0,2,2021-11-15
"DulcesNoticias","aimplas",2,0,0,2,2021-11-15
"EcoconstruMag","aimplas",2,0,0,2,2021-11-15
"ecoticiasRED","aimplas",2,0,0,2,2021-11-15
"ECOTOX2","aimplas",2,0,0,2,2021-11-15
"ECOTOX2","FBiodiversidad",2,0,0,2,2021-11-15
"ECOTOX2","FValenciaport",2,0,0,2,2021-11-15
"ECOTOX2","uvigo",2,0,0,2,2021-11-15
"EDICIONESSIBILA","AIDIMME",2,0,0,2,2021-11-15
"EDICIONESSIBILA","aimplas",2,0,0,2,2021-11-15
"EDICIONESSIBILA","InescopTech",2,0,0,2,2021-11-15
"edpemo","AgoraScience",1,0,1,2,2021-11-15
"EduTorregrosa12","skrollerbelt",1,0,1,2,2021-11-15
"EFEcomunica","aimplas",2,0,0,2,2021-11-15
"elEconomistaCV","Redit_es",2,0,0,2,2021-11-15
"elperiodic","Actecosl",2,0,0,2,2021-11-15
"elperiodic","aimplas",2,0,0,2,2021-11-15
"emprenemjunts","AIDIMME",2,0,0,2,2021-11-15
"emprenemjunts","aitex_es",2,0,0,2,2021-11-15
"emprenemjunts","GVAeconomia",2,0,0,2,2021-11-15
"emprenemjunts","GVAivace",2,0,0,2,2021-11-15
"emprenemjunts","InescopTech",2,0,0,2,2021-11-15
"emprenemjunts","Redit_es",2,0,0,2,2021-11-15
"emprenemjunts","UPV",2,0,0,2,2021-11-15
"entidadPTV","aimplas",2,0,0,2,2021-11-15
"Equiplast","amec_asoc",2,0,0,2,2021-11-15
"Erumgroup","aimplas",2,0,0,2,2021-11-15
"Erumgroup","GVAavi",2,0,0,2,2021-11-15
"escamilla50","ceeivalencia",2,0,0,2,2021-11-15
"escamilla50","generalitat",2,0,0,2,2021-11-15
"escamilla50","Startup_VLC",2,0,0,2,2021-11-15
"esplasticos","esplasticos",2,0,0,2,2021-11-15
"excedentesolar","BrigadistaR",1,0,1,2,2021-11-15
"FabricaPodcast","ITC_ceramica",1,0,1,2,2021-11-15
"Fedit","AIDIMME",2,0,0,2,2021-11-15
"Fedit","aiglesiasfraga",2,0,0,2,2021-11-15
"Fedit","CETEM_CT",2,0,0,2,2021-11-15
"Fedit","disruptores_inn",1,1,0,2,2021-11-15
"Fedit","Eurecat_news",2,0,0,2,2021-11-15
"Fedit","GVAivace",2,0,0,2,2021-11-15
"Ferfollos","Regmurcialimpia",1,0,1,2,2021-11-15
"Fernando_Ca_63","aimplas",2,0,0,2,2021-11-15
"FEVEC_Valencia","FEVEC_Valencia",2,0,0,2,2021-11-15
"ffe_es","CienciaGob",2,0,0,2,2021-11-15
"ffe_es","ImdeaMaterials",2,0,0,2,2021-11-15
"ffe_es","NavantiaOficial",2,0,0,2,2021-11-15
"fgirona","anacanoarribas",1,0,1,2,2021-11-15
"FGlobalis","aimplas",2,0,0,2,2021-11-15
"FIDAMC_","aimplas",2,0,0,2,2021-11-15
"fihguv","aimplas",2,0,0,2,2021-11-15
"fihguv","GVAavi",2,0,0,2,2021-11-15
"fihguv","ibv_org",2,0,0,2,2021-11-15
"financialfood","aimplas",1,0,1,2,2021-11-15
"FlotantProject","ITA_RWTHAachen",2,0,0,2,2021-11-15
"food_retail","aimplas",2,0,0,2,2021-11-15
"Food4LifeSPAIN","aimplas",2,0,0,2,2021-11-15
"Food4LifeSPAIN","Food4LifeSPAIN",2,0,0,2,2021-11-15
"Food4LifeSPAIN","Fuelium_",2,0,0,2,2021-11-15
"Food4LifeSPAIN","packcluster",2,0,0,2,2021-11-15
"ForoQyS","BASF_ES",2,0,0,2,2021-11-15
"ForoQyS","Cicloplast_com",2,0,0,2,2021-11-15
"ForoQyS","PlasticsEuropES",2,0,0,2,2021-11-15
"ForoQyS","Redit_es",1,1,0,2,2021-11-15
"ForoQyS","Repsol",2,0,0,2,2021-11-15
"ForoQyS","SABIC",2,0,0,2,2021-11-15
"Fryjole","CDTIoficial",1,0,1,2,2021-11-15
"Fryjole","EmbEspTurquia",2,0,0,2,2021-11-15
"FuturEnviro","Actecosl",2,0,0,2,2021-11-15
"FuturEnviro","ANARPLA",2,0,0,2,2021-11-15
"FuturEnviro","Benihort",2,0,0,2,2021-11-15
"FuturEnviro","CarmofProject",2,0,0,2,2021-11-15
"FuturEnviro","GlobalOmnium",2,0,0,2,2021-11-15
"FuturEnviro","IBMCP",2,0,0,2,2021-11-15
"FuturEnviro","TeknikerOficial",2,0,0,2,2021-11-15
"FuturEnviro","VeoliaWaterTech",2,0,0,2,2021-11-15
"GBDC78","Actuenviro",1,0,1,2,2021-11-15
"gbelenguer","javiergarciamar",1,0,1,2,2021-11-15
"GimenoGroup","MartaEGMosquera",1,0,1,2,2021-11-15
"GlobalOmnium","aimplas",2,0,0,2,2021-11-15
"GlobalOmnium","capasvil",2,0,0,2,2021-11-15
"GlobalOmnium","GlobalOmnium",2,0,0,2,2021-11-15
"GlobalOmnium","GVAavi",2,0,0,2,2021-11-15
"GlobalOmnium","GVAinnova",2,0,0,2,2021-11-15
"GlobalOmnium","UVa_es",2,0,0,2,2021-11-15
"GoHubTech","aganovagrupo",2,0,0,2,2021-11-15
"GoHubTech","EosOrbital",2,0,0,2,2021-11-15
"GoHubTech","GlobalOmnium",2,0,0,2,2021-11-15
"GoHubTech","lasprovincias",2,0,0,2,2021-11-15
"GoHubTech","LinkenerSpain",2,0,0,2,2021-11-15
"GrupoSorollaEdu","aimplas",2,0,0,2,2021-11-15
"GrupoSorollaEdu","Club_Excelencia",1,0,1,2,2021-11-15
"GrupoSorollaEdu","ColegioSalliver",2,0,0,2,2021-11-15
"GrupoTHM","aimplas",2,0,0,2,2021-11-15
"GVAavi","HospitalLaFe",2,0,0,2,2021-11-15
"GVAavi","idainature",1,1,0,2,2021-11-15
"GVAavi","UA_Universitat",2,0,0,2,2021-11-15
"GVAeconomia","aimplas",2,0,0,2,2021-11-15
"GVAeconomia","GVAivace",2,0,0,2,2021-11-15
"GVAeconomia","Rafa_Climentg",2,0,0,2,2021-11-15
"GVAinnova","aimplas",1,1,0,2,2021-11-15
"GVAivace","ainiatecnologia",2,0,0,2,2021-11-15
"GVAivace","InescopTech",2,0,0,2,2021-11-15
"GVAivace","itene",2,0,0,2,2021-11-15
"GVAivace","seimedcv",1,1,0,2,2021-11-15
"GVAivace","skrollerbelt",2,0,0,2,2021-11-15
"H2020_Partner","IreneLarroy",2,0,0,2,2021-11-15
"H2020_Partner","talk2much12",1,0,1,2,2021-11-15
"HABRILAN","aitex_es",2,0,0,2,2021-11-15
"HABRILAN","CDTIoficial",2,0,0,2,2021-11-15
"HABRILAN","CMplastik",2,0,0,2,2021-11-15
"HABRILAN","Colquimva",2,0,0,2,2021-11-15
"HABRILAN","Eurecat_news",2,0,0,2,2021-11-15
"HABRILAN","InescopTech",2,0,0,2,2021-11-15
"hasta_el_lunes","aimplas",2,0,0,2,2021-11-15
"hasta_el_lunes","reverdeconcausa",1,0,1,2,2021-11-15
"iambiente","Redit_es",2,0,0,2,2021-11-15
"IBMCP","aimplas",2,0,0,2,2021-11-15
"IBMCP","Benihort",2,0,0,2,2021-11-15
"IBMCP","IBMCP",2,0,0,2,2021-11-15
"IDG_tv","ADEMI_Informa",2,0,0,2,2021-11-15
"IDG_tv","AIDIMME",2,0,0,2,2021-11-15
"IDG_tv","aimplas",2,0,0,2,2021-11-15
"IDG_tv","ainiatecnologia",2,0,0,2,2021-11-15
"IDG_tv","CEPCO_es",2,0,0,2,2021-11-15
"IDG_tv","confemetal",2,0,0,2,2021-11-15
"IDG_tv","esFIAB",2,0,0,2,2021-11-15
"IDG_tv","FedeconModa",2,0,0,2,2021-11-15
"IDG_tv","Fedit",2,0,0,2,2021-11-15
"IDG_tv","itene",2,0,0,2,2021-11-15
"IDG_tv","sernauto",2,0,0,2,2021-11-15
"IDG_tv","SocEspCeramVidr",2,0,0,2,2021-11-15
"iiama_upv","GVAavi",2,0,0,2,2021-11-15
"impulsa_ciu","CTplasUy",1,1,0,2,2021-11-15
"InboplastMx","aimplas",1,0,1,2,2021-11-15
"industry_arena","AEBALL_UPMBALL",2,0,0,2,2021-11-15
"industry_arena","AerAutomation",2,0,0,2,2021-11-15
"industry_arena","aiasasociacion",2,0,0,2,2021-11-15
"industry_arena","CEPplast",2,0,0,2,2021-11-15
"industry_arena","ClusterCICAT",2,0,0,2,2021-11-15
"industry_arena","innovallcluster",2,0,0,2,2021-11-15
"innotransfer","GVAavi",2,0,0,2,2021-11-15
"iolunadeJupiter","CSIC",1,0,1,2,2021-11-15
"IreneLarroy","ai_eic",2,0,0,2,2021-11-15
"IreneLarroy","AristosInfo",1,0,1,2,2021-11-15
"iResiduo","UVa_es",2,0,0,2,2021-11-15
"ISWA_org","aimplas",2,0,0,2,2021-11-15
"ISWA_org","Centexbel",2,0,0,2,2021-11-15
"ISWA_org","DECOATEU",2,0,0,2,2021-11-15
"ISWA_org","RESCOLL",2,0,0,2,2021-11-15
"ITACYL","aimplas",2,0,0,2,2021-11-15
"ITACYL","FGULEM",2,0,0,2,2021-11-15
"ITACYL","fgusal",2,0,0,2,2021-11-15
"ITACYL","FundacionUBU",2,0,0,2,2021-11-15
"ITACYL","fungeuva",2,0,0,2,2021-11-15
"ITC_ceramica","CienciaGob",2,0,0,2,2021-11-15
"ITC_ceramica","GVAavi",2,0,0,2,2021-11-15
"itenergia","grupoenercoop",2,0,0,2,2021-11-15
"itenergia","sapiensenergia",2,0,0,2,2021-11-15
"ITQ_UPVCSIC","aimplas",2,0,0,2,2021-11-15
"ITQ_UPVCSIC","GVAavi",2,0,0,2,2021-11-15
"ITQ_UPVCSIC","IISLaFe",2,0,0,2,2021-11-15
"ITQ_UPVCSIC","ITQ_UPVCSIC",2,0,0,2,2021-11-15
"ITQ_UPVCSIC","UPV",2,0,0,2,2021-11-15
"izarotech","ANAIP_es",2,0,0,2,2021-11-15
"izarotech","BioICEP_IMGGE",1,0,1,2,2021-11-15
"izarotech","raorsamaq",1,0,1,2,2021-11-15
"IzasaScientific","aimplas",1,1,0,2,2021-11-15
"jadfrias","deborahciencia",2,0,0,2,2021-11-15
"jadfrias","SusChemSpain",1,0,1,2,2021-11-15
"JCGarcia_CDTI","aimplas",2,0,0,2,2021-11-15
"JCGarcia_CDTI","CDTIoficial",0,2,0,2,2021-11-15
"JECComposites","aimplas",2,0,0,2,2021-11-15
"jhomstor","AgoraScience",2,0,0,2,2021-11-15
"jhomstor","aimplas",2,0,0,2,2021-11-15
"jhomstor","AvepAsociacion",2,0,0,2,2021-11-15
"jhomstor","Avia_automocion",2,0,0,2,2021-11-15
"jhomstor","CEPplast",2,0,0,2,2021-11-15
"jhomstor","HP",2,0,0,2,2021-11-15
"jhomstor","IAM3DHUB",2,0,0,2,2021-11-15
"jhomstor","industry_arena",2,0,0,2,2021-11-15
"jhomstor","PlasticsEuropES",2,0,0,2,2021-11-15
"joanros78","aimplas",1,0,1,2,2021-11-15
"juliatomas3","ibv_org",1,1,0,2,2021-11-15
"khaqanshati","ALBAsynchrotron",1,0,1,2,2021-11-15
"KimitecGroup","2Bortolozzo",2,0,0,2,2021-11-15
"KimitecGroup","aimenct",2,0,0,2,2021-11-15
"KimitecGroup","CanalUGR",2,0,0,2,2021-11-15
"KimitecGroup","KimitecGroup",0,0,2,2,2021-11-15
"KimitecGroup","mi_sustainable",2,0,0,2,2021-11-15
"KimitecGroup","VITObelgium",2,0,0,2,2021-11-15
"lacarolinajaen","skrollerbelt",1,0,1,2,2021-11-15
"LasNavesINN","aimplas",2,0,0,2,2021-11-15
"LasNavesINN","carlosgaliana",2,0,0,2,2021-11-15
"LasNavesINN","FerminCerezo",2,0,0,2,2021-11-15
"LasNavesINN","LasNavesCOLLAB",2,0,0,2,2021-11-15
"LasNavesINN","marta_chillaron",2,0,0,2,2021-11-15
"LifeEpsSure","aimplas",2,0,0,2,2021-11-15
"LifeEpsSure","LIFEprogramme",2,0,0,2,2021-11-15
"lilifondevila","FuturEnviro",1,0,1,2,2021-11-15
"LinkenerSpain","aimplas",2,0,0,2,2021-11-15
"LISSolutionsTW","aimplas",2,0,0,2,2021-11-15
"LolaFPaniagua","aimplas",2,0,0,2,2021-11-15
"londones","PlatinoEduca",1,0,1,2,2021-11-15
"luisagilrj","aimplas",1,0,1,2,2021-11-15
"luispatinoangel","Hispackbcn",1,0,1,2,2021-11-15
"luispatinoangel","omegagenesisca",2,0,0,2,2021-11-15
"MadresXClimaCan","AEMArm",2,0,0,2,2021-11-15
"MadresXClimaCan","aimplas",2,0,0,2,2021-11-15
"MadresXClimaCan","fempcomunica",2,0,0,2,2021-11-15
"MadresXClimaCan","FMRdeMurcia",2,0,0,2,2021-11-15
"MadresXClimaCan","MadresXelClima",2,0,0,2,2021-11-15
"MadresXClimaCan","MurciaClima",2,0,0,2,2021-11-15
"MadresXClimaCan","plastic_britain",2,0,0,2,2021-11-15
"MadresXClimaCan","UpcyclingMadrid",2,0,0,2,2021-11-15
"MadresXClimaCan","Vertidos_Cero",2,0,0,2,2021-11-15
"marijosidemaya","aimplas",2,0,0,2,2021-11-15
"marijosidemaya","AmigosTierraEsp",2,0,0,2,2021-11-15
"marijosidemaya","Ferfollos",2,0,0,2,2021-11-15
"marijosidemaya","FFFSalamanca",2,0,0,2,2021-11-15
"marijosidemaya","ICTA_UAB",2,0,0,2,2021-11-15
"marijosidemaya","MadresXelClima",2,0,0,2,2021-11-15
"marijosidemaya","PaisajeLimpio",2,0,0,2,2021-11-15
"marijosidemaya","Regmurcialimpia",2,0,0,2,2021-11-15
"marijosidemaya","somoscidec",2,0,0,2,2021-11-15
"marijosidemaya","xrmadrid_",2,0,0,2,2021-11-15
"MartaEGMosquera","eldiarioclm",1,1,0,2,2021-11-15
"MartaEGMosquera","GimenoGroup",1,0,1,2,2021-11-15
"Mateprincs","AaronCa04190760",2,0,0,2,2021-11-15
"Mateprincs","LOPECMunich",2,0,0,2,2021-11-15
"Mateprincs","Naitec_CT",2,0,0,2,2021-11-15
"materplat","aimplas",2,0,0,2,2021-11-15
"materplat","ImdeaMaterials",2,0,0,2,2021-11-15
"materplat","La_UPM",2,0,0,2,2021-11-15
"materplat","NavantiaOficial",2,0,0,2,2021-11-15
"MediterraneoPre","capasvil",1,0,1,2,2021-11-15
"MetalMadridEs","aimplas",2,0,0,2,2021-11-15
"MetalMadridEs","CompositesSpain",2,0,0,2,2021-11-15
"MetalMadridEs","MetalMadridEs",2,0,0,2,2021-11-15
"micijor","joveryolanda",1,0,1,2,2021-11-15
"MinarroFin","VAtradu",1,0,1,2,2021-11-15
"miplacebio","Actecosl",2,0,0,2,2021-11-15
"miplacebio","aimplas",2,0,0,2,2021-11-15
"miplacebio","realturfoficial",2,0,0,2,2021-11-15
"mmelgarejo3300","aimplas",1,0,1,2,2021-11-15
"MobilityVlc","aimplas",2,0,0,2,2021-11-15
"Monviciano","Energy4Europe",2,0,0,2,2021-11-15
"Monviciano","EUinKuwait",2,0,0,2,2021-11-15
"Monviciano","EUintheGCC",2,0,0,2,2021-11-15
"Monviciano","EUintheUAE",2,0,0,2,2021-11-15
"Monviciano","ExpoUpdate",2,0,0,2,2021-11-15
"mrtmi3g","asincar",1,1,0,2,2021-11-15
"mtmachado","aimplas",1,0,1,2,2021-11-15
"Mundoplast","ainiatecnologia",2,0,0,2,2021-11-15
"Mundoplast","ANAIP_es",2,0,0,2,2021-11-15
"Mundoplast","ANARPLA",2,0,0,2,2021-11-15
"Mundoplast","Cicloplast_com",2,0,0,2,2021-11-15
"NagrifoodClust","ClusterFPrint",2,0,0,2,2021-11-15
"NontoxProject","aimplas",2,0,0,2,2021-11-15
"NontoxProject","IMDEA_Energia",2,0,0,2,2021-11-15
"Novamont","aimplas",2,0,0,2,2021-11-15
"Novamont","Cicloplast_com",2,0,0,2,2021-11-15
"Novamont_Iberia","Novamont_Iberia",0,0,2,2,2021-11-15
"OanaCaro","aimplas",2,0,0,2,2021-11-15
"OanaCaro","ICTA_UAB",2,0,0,2,2021-11-15
"OanaCaro","PaisajeLimpio",2,0,0,2,2021-11-15
"OanaCaro","somoscidec",2,0,0,2,2021-11-15
"OC_Composites","AEMAC_",2,0,0,2,2021-11-15
"OC_Composites","aimplas",2,0,0,2,2021-11-15
"OC_Composites","aitex_es",2,0,0,2,2021-11-15
"OC_Composites","CDTIoficial",2,0,0,2,2021-11-15
"OC_Composites","CMplastik",2,0,0,2,2021-11-15
"OC_Composites","Colquimva",2,0,0,2,2021-11-15
"OC_Composites","CompositesQuim",2,0,0,2,2021-11-15
"OC_Composites","Feria_Valencia",2,0,0,2,2021-11-15
"OC_Composites","feriaecofira",2,0,0,2,2021-11-15
"OC_Composites","GVAivace",2,0,0,2,2021-11-15
"OC_Composites","InescopTech",2,0,0,2,2021-11-15
"OC_Composites","Redit_es",2,0,0,2,2021-11-15
"OceanetsProject","EU_EASME",2,0,0,2,2021-11-15
"OceanetsProject","uvigo",2,0,0,2,2021-11-15
"omenendez","SusChemSpain",1,0,1,2,2021-11-15
"opdi_tex_GmbH","CompositeUnited",1,0,1,2,2021-11-15
"OpenFuture_And","byproductplace",1,0,1,2,2021-11-15
"OVTT","OEPM_es",2,0,0,2,2021-11-15
"pablo24200","Vertidos_Cero",1,0,1,2,2021-11-15
"packcluster","industry_arena",1,0,1,2,2021-11-15
"Packnet_","anape",2,0,0,2,2021-11-15
"Packnet_","anape_eps",0,2,0,2,2021-11-15
"Packnet_","CticCita",2,0,0,2,2021-11-15
"Packnet_","iambiente",0,2,0,2,2021-11-15
"Packnet_","packcluster",2,0,0,2,2021-11-15
"Packnet_","PKF_INNCOME",2,0,0,2,2021-11-15
"PacoFernandezA2","MartaEGMosquera",1,0,1,2,2021-11-15
"PactoMundial","aimplas",2,0,0,2,2021-11-15
"Pascual","ter4bithi4",1,0,1,2,2021-11-15
"PCT_UCN","GVAivace",1,0,1,2,2021-11-15
"pharmamarket","Biopolis_SL",2,0,0,2,2021-11-15
"pHjools","CentrosCex",1,0,1,2,2021-11-15
"PilMontana","PlasticsEuropES",1,0,1,2,2021-11-15
"PilotHarbour","aimplas",2,0,0,2,2021-11-15
"plastic_museum","aimplas",1,0,1,2,2021-11-15
"PlasticFV","Cicloplast_com",2,0,0,2,2021-11-15
"PlasticFV","Envaspres",2,0,0,2,2021-11-15
"PlasticFV","ITC_Packaging",2,0,0,2,2021-11-15
"PlasticFV","Mundoplast",2,0,0,2,2021-11-15
"plasticomty","10t_proyectos",1,0,1,2,2021-11-15
"PlasticsEuropES","PlasticsEuropES",0,0,2,2,2021-11-15
"PlasticsWorld","Actecosl",2,0,0,2,2021-11-15
"PlasticsWorld","realturfoficial",2,0,0,2,2021-11-15
"platformtierra","aimplas",2,0,0,2,2021-11-15
"PMI_Valencia","aimplas",2,0,0,2,2021-11-15
"PReivindicativa","aimplas",1,0,1,2,2021-11-15
"PT3NEO","aimplas",2,0,0,2,2021-11-15
"PT3NEO","ClusterFPrint",2,0,0,2,2021-11-15
"RachelRock2","AIJU_Tecnologi",1,0,1,2,2021-11-15
"RamnBertNavarro","CSIC",1,0,1,2,2021-11-15
"RamSG20","CSIC",1,0,1,2,2021-11-15
"rappicupons105","i_alimentacion",1,0,1,2,2021-11-15
"reciclajeFER","aimplas",2,0,0,2,2021-11-15
"RECOTRANS_H2020","aimplas",2,0,0,2,2021-11-15
"Recuwaste","ivanalbertos81",1,0,1,2,2021-11-15
"Redit_es","CIDETEC_",2,0,0,2,2021-11-15
"Redit_es","Contact_AMI",2,0,0,2,2021-11-15
"Redit_es","esplasticos",2,0,0,2,2021-11-15
"Redit_es","EU_EASME",1,1,0,2,2021-11-15
"Redit_es","garcia_saludes",2,0,0,2,2021-11-15
"Redit_es","Julia_company",2,0,0,2,2021-11-15
"Redit_es","mincoturgob",2,0,0,2,2021-11-15
"Redit_es","OndaCero_es",2,0,0,2,2021-11-15
"Redit_es","plastic_museum",2,0,0,2,2021-11-15
"Redit_es","Rafa_Climentg",2,0,0,2,2021-11-15
"Redit_es","ServiReach",2,0,0,2,2021-11-15
"Redit_es","UPV",2,0,0,2,2021-11-15
"Regmurcialimpia","basurasmarinas",2,0,0,2,2021-11-15
"Regmurcialimpia","BIOnTop_Project",1,0,1,2,2021-11-15
"Regmurcialimpia","FuturEnviro",1,0,1,2,2021-11-15
"Regmurcialimpia","Regmurcialimpia",0,0,2,2,2021-11-15
"Regmurcialimpia","THADERCONSUMO",2,0,0,2,2021-11-15
"REMADYL_EU","aimplas",2,0,0,2,2021-11-15
"REMADYL_EU","azorambiental",2,0,0,2,2021-11-15
"REMADYL_EU","Centexbel",2,0,0,2,2021-11-15
"REMADYL_EU","DANOSA_SPAIN",2,0,0,2,2021-11-15
"REMADYL_EU","Deceuninck",2,0,0,2,2021-11-15
"REMADYL_EU","iris_rd",2,0,0,2,2021-11-15
"REMADYL_EU","REMADYL_EU",1,1,0,2,2021-11-15
"REMADYL_EU","SPIRE2030",1,1,0,2,2021-11-15
"REMADYL_EU","SustainableInnE",2,0,0,2,2021-11-15
"REMADYL_EU","UV_EG",2,0,0,2,2021-11-15
"REMADYL_EU","Vinylplus_it",2,0,0,2,2021-11-15
"RepetCoinnova","Cicloplast_com",2,0,0,2,2021-11-15
"RepetCoinnova","RepetCoinnova",2,0,0,2,2021-11-15
"reverdeconcausa","hasta_el_lunes",1,0,1,2,2021-11-15
"RevistaMercados","Afi_es",2,0,0,2,2021-11-15
"RevistaMercados","ANAIP_es",2,0,0,2,2021-11-15
"RevistaMercados","ANARPLA",2,0,0,2,2021-11-15
"RevistaMercados","fCIRCE",2,0,0,2,2021-11-15
"RevistaMercados","ICTA_UAB",2,0,0,2,2021-11-15
"RevistaMercados","IDAEA_CSIC",2,0,0,2,2021-11-15
"RevistaMercados","PaisajeLimpio",2,0,0,2,2021-11-15
"RevistaMercados","somoscidec",2,0,0,2,2021-11-15
"RevistaMercados","Vertidos_Cero",2,0,0,2,2021-11-15
"RevistaRETEMA","ANARPLA",2,0,0,2,2021-11-15
"RevistaRETEMA","InescopTech",2,0,0,2,2021-11-15
"rrecycling","aimplas",2,0,0,2,2021-11-15
"SagredoMarco","AIDIMME",2,0,0,2,2021-11-15
"SanchisFederico","AdelaRuizD",2,0,0,2,2021-11-15
"SanchisFederico","ITI_TIC",2,0,0,2,2021-11-15
"SanchisFederico","SanchisFederico",0,0,2,2,2021-11-15
"Santa_Teresa","ITACYL",1,1,0,2,2021-11-15
"SDDR_info","FuturEnviro",1,0,1,2,2021-11-15
"silviaavilesg","Cicloplast_com",2,0,0,2,2021-11-15
"silviaavilesg","esplasticos",2,0,0,2,2021-11-15
"SmartCityJour_","aimplas",1,0,1,2,2021-11-15
"SOMM_alliance","Afi_es",2,0,0,2,2021-11-15
"SOMM_alliance","aimplas",2,0,0,2,2021-11-15
"SOMM_alliance","fCIRCE",2,0,0,2,2021-11-15
"SOMM_alliance","PaisajeLimpio",2,0,0,2,2021-11-15
"SOMM_alliance","somoscidec",2,0,0,2,2021-11-15
"SOMM_alliance","Vertidos_Cero",2,0,0,2,2021-11-15
"somoscidec","Vertidos_Cero",2,0,0,2,2021-11-15
"SoniaHe49592177","CSIC",1,0,1,2,2021-11-15
"SoniTirado","aimplas",1,0,1,2,2021-11-15
"SreeparnaDas20","aimplas",1,0,1,2,2021-11-15
"tabitbilisim","Azmudeu",1,1,0,2,2021-11-15
"tabitbilisim","tabitbilisim",2,0,0,2,2021-11-15
"talk2much12","itene",2,0,0,2,2021-11-15
"tecnalia","pteco2",1,1,0,2,2021-11-15
"Tecnifood","ANARPLA",2,0,0,2,2021-11-15
"Tecnifood","Biopolis_SL",2,0,0,2,2021-11-15
"Tecnifood","espaitec",2,0,0,2,2021-11-15
"tecnoaqua","AseTUB",1,0,1,2,2021-11-15
"tecplastico","aimplas",2,0,0,2,2021-11-15
"TitoCrissien","aimplas",2,0,0,2,2021-11-15
"TRAKTECH_","AvepAsociacion",2,0,0,2,2021-11-15
"ucvalencia","Redit_es",1,0,1,2,2021-11-15
"UNLOCK_BBI","aimplas",2,0,0,2,2021-11-15
"veredictas","int_envase",2,0,0,2,2021-11-15
"veredictas","salesianssarria",2,0,0,2,2021-11-15
"Vertidos_Cero","ecoalf",2,0,0,2,2021-11-15
"Vertidos_Cero","FValenciaport",2,0,0,2,2021-11-15
"Vertidos_Cero","mitecogob",2,0,0,2,2021-11-15
"Vertidos_Cero","pablo24200",1,0,1,2,2021-11-15
"Vertidos_Cero","RubenRguezAl",1,0,1,2,2021-11-15
"VicenteAbella","MinarroFin",1,0,1,2,2021-11-15
"vincenzo_gente","aimplas",1,0,1,2,2021-11-15
"VLCTechCity","aimplas",2,0,0,2,2021-11-15
"Wendy_Moreno_EU","accio_cat",2,0,0,2,2021-11-15
"Wendy_Moreno_EU","aimplas",2,0,0,2,2021-11-15
"Wendy_Moreno_EU","AristosInfo",2,0,0,2,2021-11-15
"Wendy_Moreno_EU","biocat_cat",2,0,0,2,2021-11-15
"Wendy_Moreno_EU","CDTIoficial",2,0,0,2,2021-11-15
"Wendy_Moreno_EU","eencat",2,0,0,2,2021-11-15
"Wendy_Moreno_EU","Eurecat_news",2,0,0,2,2021-11-15
"Wendy_Moreno_EU","H2020_Partner",2,0,0,2,2021-11-15
"Wendy_Moreno_EU","horizonexperts",2,0,0,2,2021-11-15
"Wendy_Moreno_EU","IreneLarroy",2,0,0,2,2021-11-15
"Wendy_Moreno_EU","itene",2,0,0,2,2021-11-15
"Wendy_Moreno_EU","JCGarcia_CDTI",2,0,0,2,2021-11-15
"Wendy_Moreno_EU","jordipietx",2,0,0,2,2021-11-15
"Wendy_Moreno_EU","RosaAriasAlv",2,0,0,2,2021-11-15
"Wendy_Moreno_EU","scibus",2,0,0,2,2021-11-15
"Wendy_Moreno_EU","SorosGabinete",2,0,0,2,2021-11-15
"Wendy_Moreno_EU","talk2much12",2,0,0,2,2021-11-15
"WomenInPlastic","BritishPlastics",1,1,0,2,2021-11-15
"WriterAlejandro","Agrimax_EU",1,0,1,2,2021-11-15
"x_campos","aimplas",1,0,1,2,2021-11-15
"_rtvemarcae","aimplas",1,0,0,1,2021-11-15
"1785es","AceitesOlivaES",1,0,0,1,2021-11-15
"1785es","aimplas",1,0,0,1,2021-11-15
"1785es","andaluciae",1,0,0,1,2021-11-15
"1785es","cadecordobaAE",1,0,0,1,2021-11-15
"1785es","CordobaBN",1,0,0,1,2021-11-15
"1785es","elespanolcom",1,0,0,1,2021-11-15
"3duardoFG","aimplas",1,0,0,1,2021-11-15
"3duardoFG","ANAIP_es",1,0,0,1,2021-11-15
"3duardoFG","charo_barroso",1,0,0,1,2021-11-15
"3duardoFG","Cicloplast_com",1,0,0,1,2021-11-15
"3duardoFG","esplasticos",1,0,0,1,2021-11-15
"3duardoFG","greenpeace_esp",1,0,0,1,2021-11-15
"3duardoFG","PlasticsEuropES",1,0,0,1,2021-11-15
"3duardoFG","StockTerabithia",1,0,0,1,2021-11-15
"3duardoFG","TFundaciones",1,0,0,1,2021-11-15
"3Recycler","aimplas",1,0,0,1,2021-11-15
"3Recycler","ANAIP_es",1,0,0,1,2021-11-15
"3Recycler","Cicloplast_com",1,0,0,1,2021-11-15
"3Recycler","esplasticos",1,0,0,1,2021-11-15
"3Recycler","eurenext",1,0,0,1,2021-11-15
"7TeleValencia","aimplas",1,0,0,1,2021-11-15
"aalbaperez","_iterh_",1,0,0,1,2021-11-15
"aalbaperez","AIDIMME",1,0,0,1,2021-11-15
"aalbaperez","itenergia",1,0,0,1,2021-11-15
"AbelardoDuran","ANAIP_es",1,0,0,1,2021-11-15
"AbelardoDuran","Cicloplast_com",1,0,0,1,2021-11-15
"AbelardoDuran","silviaavilesg",0,0,1,1,2021-11-15
"acanocoloma","aimplas",1,0,0,1,2021-11-15
"acanocoloma","CentrosCex",1,0,0,1,2021-11-15
"acanocoloma","escamilla50",1,0,0,1,2021-11-15
"acanocoloma","generalitat",1,0,0,1,2021-11-15
"acanocoloma","GVAivace",1,0,0,1,2021-11-15
"acanocoloma","Julia_company",1,0,0,1,2021-11-15
"acanocoloma","Rafa_Climentg",1,0,0,1,2021-11-15
"Actecosl","aimplas",1,0,0,1,2021-11-15
"Actuenviro","aimplas",1,0,0,1,2021-11-15
"Actuenviro","Benkei_Fr",1,0,0,1,2021-11-15
"Actuenviro","CT_IPC",1,0,0,1,2021-11-15
"Actuenviro","filigrade",1,0,0,1,2021-11-15
"Actuenviro","PellencGroup",1,0,0,1,2021-11-15
"Actuenviro","Pollutec",1,0,0,1,2021-11-15
"Actuenviro","ProspexInst",1,0,0,1,2021-11-15
"ADBioplastics","ADBioplastics",1,0,0,1,2021-11-15
"ADBioplastics","aimplas",1,0,0,1,2021-11-15
"ADBioplastics","bioplasticsmag",1,0,0,1,2021-11-15
"ADBioplastics","TotalCorbionPLA",1,0,0,1,2021-11-15
"ADCV_com","AIDIMME",1,0,0,1,2021-11-15
"ADCV_com","AIJU_Tecnologi",1,0,0,1,2021-11-15
"ADCV_com","aimplas",1,0,0,1,2021-11-15
"ADCV_com","ainiatecnologia",1,0,0,1,2021-11-15
"ADCV_com","aitex_es",1,0,0,1,2021-11-15
"ADCV_com","ibv_org",1,0,0,1,2021-11-15
"ADCV_com","InescopTech",1,0,0,1,2021-11-15
"ADCV_com","ITC_ceramica",1,0,0,1,2021-11-15
"ADCV_com","itene",1,0,0,1,2021-11-15
"ADCV_com","itenergia",1,0,0,1,2021-11-15
"ADCV_com","ITI_TIC",1,0,0,1,2021-11-15
"AdonaiHM","asociacionruvid",1,0,0,1,2021-11-15
"AdonaiHM","AVEmpresarios",1,0,0,1,2021-11-15
"AdonaiHM","c_valenciana",1,0,0,1,2021-11-15
"AdonaiHM","emparmbonafe",1,0,0,1,2021-11-15
"AdonaiHM","FundacionETNOR",1,0,0,1,2021-11-15
"AdonaiHM","GVAavi",1,0,0,1,2021-11-15
"AdonaiHM","GVAddigital",1,0,0,1,2021-11-15
"AdonaiHM","GVAinnova",1,0,0,1,2021-11-15
"AdonaiHM","ITC_ceramica",1,0,0,1,2021-11-15
"AdonaiHM","PremiosReiJaume",1,0,0,1,2021-11-15
"AdonaiHM","RectoraUA",1,0,0,1,2021-11-15
"AdonaiHM","UA_Universidad",1,0,0,1,2021-11-15
"AdvanFactories","AEMAC_",1,0,0,1,2021-11-15
"AdvanFactories","Airbus",1,0,0,1,2021-11-15
"AdvanFactories","CDTIoficial",1,0,0,1,2021-11-15
"AdvanFactories","DANOBATGROUP",1,0,0,1,2021-11-15
"AdvanFactories","industriQuimica",1,0,0,1,2021-11-15
"AdvanFactories","infoedita",1,0,0,1,2021-11-15
"AdvanFactories","TalgoGroup",1,0,0,1,2021-11-15
"AdvanFactories","UdGPolitecnica",1,0,0,1,2021-11-15
"aec_es","eurofirms",1,0,0,1,2021-11-15
"aec_es","Kapture_io",1,0,0,1,2021-11-15
"aec_es","rnconsulting_es",1,0,0,1,2021-11-15
"aec_es","Sisteplant",1,0,0,1,2021-11-15
"aec_es","tuSEAT",1,0,0,1,2021-11-15
"aec_es","ZF_Group",1,0,0,1,2021-11-15
"AEMAC_","AdvanFactories",1,0,0,1,2021-11-15
"AEMAC_","AlestisAerospac",1,0,0,1,2021-11-15
"AEMAC_","Arkema_group",1,0,0,1,2021-11-15
"AEMAC_","ascameorg",1,0,0,1,2021-11-15
"AEMAC_","camarascomercio",1,0,0,1,2021-11-15
"AEMAC_","cambrabcn",1,0,0,1,2021-11-15
"AEMAC_","DANOBAT",1,0,0,1,2021-11-15
"AEMAC_","eoi",1,0,0,1,2021-11-15
"AEMAC_","EsAirbus",1,0,0,1,2021-11-15
"AEMAC_","Eurecat",1,0,0,1,2021-11-15
"AEMAC_","Fraunhofer",1,0,0,1,2021-11-15
"AEMAC_","IFEMA",1,0,0,1,2021-11-15
"AEMAC_","industrialesand",1,0,0,1,2021-11-15
"AEMAC_","itea",1,0,0,1,2021-11-15
"AEMAC_","iteamUPV",1,0,0,1,2021-11-15
"AEMAC_","MADRID",1,0,0,1,2021-11-15
"AEMAC_","MaterialCharact",1,0,0,1,2021-11-15
"AEMAC_","MetalMadridEs",1,0,0,1,2021-11-15
"AEMAC_","MtorresRsc",1,0,0,1,2021-11-15
"AEMAC_","MUnibertsitatea",1,0,0,1,2021-11-15
"AEMAC_","packcluster",1,0,0,1,2021-11-15
"AEMAC_","PatronalCecot",1,0,0,1,2021-11-15
"AEMAC_","PlasticsEurope",1,0,0,1,2021-11-15
"AEMAC_","silviaavilesg",0,0,1,1,2021-11-15
"AEMAC_","SusChemSpain",1,0,0,1,2021-11-15
"AEMAC_","talgo",1,0,0,1,2021-11-15
"AEMAC_","uc3m",1,0,0,1,2021-11-15
"AEMAC_","UdGPolitecnica",1,0,0,1,2021-11-15
"AEMAC_","unisevilla",1,0,0,1,2021-11-15
"AEMAC_","ZundCutter",1,0,0,1,2021-11-15
"AErasmusproject","MedScan3D",1,0,0,1,2021-11-15
"AErasmusproject","TheAMRC",1,0,0,1,2021-11-15
"aevae_es","aimplas",1,0,0,1,2021-11-15
"aevae_es","Cicloplast_com",1,0,0,1,2021-11-15
"afercuello","aimplas",1,0,0,1,2021-11-15
"afercuello","AragonCircular",1,0,0,1,2021-11-15
"afercuello","AytoCalatayud",1,0,0,1,2021-11-15
"afercuello","CAARAUTOARAGON",1,0,0,1,2021-11-15
"agapi_comunica","aimplas",1,0,0,1,2021-11-15
"agapi_comunica","corifyAF",1,0,0,1,2021-11-15
"agapi_comunica","Grupo_TSK",1,0,0,1,2021-11-15
"agapi_comunica","Molecor",1,0,0,1,2021-11-15
"agapi_comunica","PigCHAMP_Europa",1,0,0,1,2021-11-15
"agapi_comunica","skrollerbelt",1,0,0,1,2021-11-15
"AgoraScience","AgoraScience",0,1,0,1,2021-11-15
"AgoraScience","astro_duque",1,0,0,1,2021-11-15
"AgoraScience","AureaRodriguezL",1,0,0,1,2021-11-15
"AgoraScience","CDTIoficial",1,0,0,1,2021-11-15
"AgoraScience","CEPplast",1,0,0,1,2021-11-15
"AgoraScience","CienciaGob",1,0,0,1,2021-11-15
"AgoraScience","CtqcQuimica",1,0,0,1,2021-11-15
"AgoraScience","Equiplast",1,0,0,1,2021-11-15
"AgoraScience","fecyt",1,0,0,1,2021-11-15
"AgoraScience","FECYT_Ciencia",1,0,0,1,2021-11-15
"AgoraScience","GraphispackAsoc",1,0,0,1,2021-11-15
"AgoraScience","graphispag2021",1,0,0,1,2021-11-15
"AgoraScience","idibaps",1,0,0,1,2021-11-15
"AgoraScience","IndustriaGob",1,0,0,1,2021-11-15
"AgoraScience","industry_arena",1,0,0,1,2021-11-15
"AgoraScience","jsanfeliu",1,0,0,1,2021-11-15
"AgoraScience","JSansaloni",1,0,0,1,2021-11-15
"AgoraScience","marcvidal",1,0,0,1,2021-11-15
"AgoraScience","PlasticsEurope",1,0,0,1,2021-11-15
"AgoraScience","x_grauvidal",1,0,0,1,2021-11-15
"AgoraScience","xcampscoma",1,0,0,1,2021-11-15
"Agrimax_EU","bioplasticsmag",1,0,0,1,2021-11-15
"agrodhuelva","aimplas",1,0,0,1,2021-11-15
"agrodhuelva","ainiatecnologia",1,0,0,1,2021-11-15
"agromac_mm","aimplas",1,0,0,1,2021-11-15
"AgroNewsCV","ANAIP_es",1,0,0,1,2021-11-15
"AgroNewsCV","ITI_TIC",1,0,0,1,2021-11-15
"AgroNewsCV","Nestle_es",1,0,0,1,2021-11-15
"AgronoticiasE","aimplas",1,0,0,1,2021-11-15
"aguaresiduales","aimplas",1,0,0,1,2021-11-15
"Aida_Herranz","Aida_Herranz",0,0,1,1,2021-11-15
"Aida_Herranz","aimplas",1,0,0,1,2021-11-15
"Aida_Herranz","EU_H2020",1,0,0,1,2021-11-15
"Aida_Herranz","ffe_es",1,0,0,1,2021-11-15
"Aida_Herranz","FoF_EU",1,0,0,1,2021-11-15
"Aida_Herranz","materplat",1,0,0,1,2021-11-15
"Aida_Herranz","RECOTRANS_H2020",1,0,0,1,2021-11-15
"AIJU_Tecnologi","AIDIMME",1,0,0,1,2021-11-15
"AIJU_Tecnologi","ainiatecnologia",1,0,0,1,2021-11-15
"AIJU_Tecnologi","aitex_es",1,0,0,1,2021-11-15
"AIJU_Tecnologi","AvamedSynergy",1,0,0,1,2021-11-15
"AIJU_Tecnologi","floridauni",1,0,0,1,2021-11-15
"AIJU_Tecnologi","FundacionVithas",1,0,0,1,2021-11-15
"AIJU_Tecnologi","ibv_org",1,0,0,1,2021-11-15
"AIJU_Tecnologi","InescopTech",1,0,0,1,2021-11-15
"AIJU_Tecnologi","ITC_ceramica",1,0,0,1,2021-11-15
"AIJU_Tecnologi","itene",1,0,0,1,2021-11-15
"AIJU_Tecnologi","itenergia",1,0,0,1,2021-11-15
"AIJU_Tecnologi","ITI_TIC",1,0,0,1,2021-11-15
"AIJU_Tecnologi","quibim",1,0,0,1,2021-11-15
"AIJU_Tecnologi","Vithas",1,0,0,1,2021-11-15
"aimplas","AIDIMME",1,0,0,1,2021-11-15
"aimplas","ainiatecnologia",1,0,0,1,2021-11-15
"aimplas","ANAIP_es",1,0,0,1,2021-11-15
"aimplas","ANARPLA",1,0,0,1,2021-11-15
"aimplas","AvepAsociacion",1,0,0,1,2021-11-15
"aimplas","basurasmarinas",1,0,0,1,2021-11-15
"aimplas","Cicloplast_com",1,0,0,1,2021-11-15
"aimplas","FGlobalis",1,0,0,1,2021-11-15
"aimplas","PlasticsEurope",1,0,0,1,2021-11-15
"aimplas","udem",1,0,0,1,2021-11-15
"aimplas","UV_EG",1,0,0,1,2021-11-15
"AIN_Navarra","aimplas",1,0,0,1,2021-11-15
"ainiatecnologia","CdeCarnica",1,0,0,1,2021-11-15
"ainiatecnologia","danone_es",1,0,0,1,2021-11-15
"ainiatecnologia","DulcesNoticias",1,0,0,1,2021-11-15
"ainiatecnologia","elEconomistaes",1,0,0,1,2021-11-15
"ainiatecnologia","faerchgroup",1,0,0,1,2021-11-15
"ainiatecnologia","FEDACOVA_VLC",1,0,0,1,2021-11-15
"ainiatecnologia","GrupoHinojosa",1,0,0,1,2021-11-15
"ainiatecnologia","GVAsanitat",1,0,0,1,2021-11-15
"ainiatecnologia","i_alimentacion",1,0,0,1,2021-11-15
"ainiatecnologia","PackagingEurope",1,0,0,1,2021-11-15
"ainiatecnologia","Redit_es",1,0,0,1,2021-11-15
"ainiatecnologia","revistaide",1,0,0,1,2021-11-15
"ainiatecnologia","RevistaRETEMA",1,0,0,1,2021-11-15
"ainiatecnologia","RSM_es",1,0,0,1,2021-11-15
"ainiatecnologia","tecnoalimen",1,0,0,1,2021-11-15
"AIPIAcongress","AIPIAcongress",1,0,0,1,2021-11-15
"AIPIAcongress","AmbrosusAMB",1,0,0,1,2021-11-15
"AIPIAcongress","AmirKhoshniyati",1,0,0,1,2021-11-15
"ait_research","AIT_Quality",1,0,0,1,2021-11-15
"ait_research","ait_research",0,1,0,1,2021-11-15
"ait_research","AlisonNiEochaid",1,0,0,1,2021-11-15
"ait_research","DeclanMDevine",1,0,0,1,2021-11-15
"ait_research","Dept_ECC",1,0,0,1,2021-11-15
"ait_research","DeptofFHed",1,0,0,1,2021-11-15
"ait_research","DrollPeter",0,1,0,1,2021-11-15
"ait_research","Horizon2020_ire",1,0,0,1,2021-11-15
"ait_research","HorizonEuropeIE",1,0,0,1,2021-11-15
"ait_research","ibetportugal",1,0,0,1,2021-11-15
"ait_research","MixUp_H2020",1,0,0,1,2021-11-15
"ait_research","paintclubHQ",1,0,0,1,2021-11-15
"ait_research","tuc_tweet",1,0,0,1,2021-11-15
"ALBAsynchrotron","aimplas",1,0,0,1,2021-11-15
"ALBAsynchrotron","CalipsoPlus",1,0,0,1,2021-11-15
"ALBAsynchrotron","cepyme_",1,0,0,1,2021-11-15
"ALBAsynchrotron","confemetal",1,0,0,1,2021-11-15
"ALBAsynchrotron","Feique_ES",1,0,0,1,2021-11-15
"alcaide_mkt","aimplas",1,0,0,1,2021-11-15
"almar_laura","aimplas",1,0,0,1,2021-11-15
"almar_laura","CSIC",1,0,0,1,2021-11-15
"almar_laura","eCOCOO2",1,0,0,1,2021-11-15
"almar_laura","expo2020dubai",1,0,0,1,2021-11-15
"almar_laura","ExpoSpain2020",1,0,0,1,2021-11-15
"almar_laura","icareplast",1,0,0,1,2021-11-15
"AlmuAlbertos","aimplas",1,0,0,1,2021-11-15
"AlmuAlbertos","corifyAF",1,0,0,1,2021-11-15
"AlmuAlbertos","Grupo_TSK",1,0,0,1,2021-11-15
"AlmuAlbertos","Molecor",1,0,0,1,2021-11-15
"AlmuAlbertos","PigCHAMP_Europa",1,0,0,1,2021-11-15
"AlmuAlbertos","PlatinoEduca",1,0,0,1,2021-11-15
"AlmuAlbertos","skrollerbelt",1,0,0,1,2021-11-15
"aLuciernaga_","aimplas",1,0,0,1,2021-11-15
"Alvaro_Eslu","GrupoCosentino",1,0,0,1,2021-11-15
"Alvaro_Eslu","UV_EG",1,0,0,1,2021-11-15
"alvizlo","aimplas",1,0,0,1,2021-11-15
"alvizlo","ainiatecnologia",1,0,0,1,2021-11-15
"alvizlo","alvizlo",0,0,1,1,2021-11-15
"ambienteeuropeo","aimplas",1,0,0,1,2021-11-15
"ambienteeuropeo","levante_emv",1,0,0,1,2021-11-15
"Amgarve","Cicloplast_com",1,0,0,1,2021-11-15
"Amgarve","Consum",1,0,0,1,2021-11-15
"Amgarve","eversiagroup",1,0,0,1,2021-11-15
"Amgarve","SaicaGroup_es",1,0,0,1,2021-11-15
"anacanoarribas","anacanoarribas",0,0,1,1,2021-11-15
"anacanoarribas","GVAavi",1,0,0,1,2021-11-15
"anacanoarribas","GVAivace",1,0,0,1,2021-11-15
"ANAIP_es","ainiatecnologia",1,0,0,1,2021-11-15
"ANAIP_es","ANAIP_es",0,0,1,1,2021-11-15
"ANAIP_es","ANARPLA",1,0,0,1,2021-11-15
"ANAIP_es","AvepAsociacion",1,0,0,1,2021-11-15
"ANAIP_es","CENER_Energia",1,0,0,1,2021-11-15
"ANAIP_es","ChemRecycleNews",1,0,0,1,2021-11-15
"ANAIP_es","deborahciencia",1,0,0,1,2021-11-15
"ANAIP_es","PlasticsEurope",1,0,0,1,2021-11-15
"ANAIP_es","SusChemSpain",1,0,0,1,2021-11-15
"anape_eps","ANAIP_es",1,0,0,1,2021-11-15
"anape_eps","ANARPLA",1,0,0,1,2021-11-15
"anape_eps","COEXPAN_",1,0,0,1,2021-11-15
"anape_eps","EU_EASME",1,0,0,1,2021-11-15
"anape_eps","LifeEpsSure",1,0,0,1,2021-11-15
"anape_eps","LIFEprogramme",1,0,0,1,2021-11-15
"anape_eps","PlasticsEuropES",1,0,0,1,2021-11-15
"AndreaCasoF","AIDIMME",1,0,0,1,2021-11-15
"AndreaCasoF","AIJU_Tecnologi",1,0,0,1,2021-11-15
"AndreaCasoF","aimplas",1,0,0,1,2021-11-15
"AndreaCasoF","ainiatecnologia",1,0,0,1,2021-11-15
"AndreaCasoF","aitex_es",1,0,0,1,2021-11-15
"AndreaCasoF","ibv_org",1,0,0,1,2021-11-15
"AndreaCasoF","InescopTech",1,0,0,1,2021-11-15
"AndreaCasoF","ITC_ceramica",1,0,0,1,2021-11-15
"AndreaCasoF","itene",1,0,0,1,2021-11-15
"AndreaCasoF","itenergia",1,0,0,1,2021-11-15
"AndreaCasoF","ITI_TIC",1,0,0,1,2021-11-15
"andresgilnogues","CEPplast",1,0,0,1,2021-11-15
"andresgilnogues","Cicloplast_com",1,0,0,1,2021-11-15
"andresgilnogues","esplasticos",1,0,0,1,2021-11-15
"andresgilnogues","feria_encaja",1,0,0,1,2021-11-15
"andresgilnogues","feriaecofira",1,0,0,1,2021-11-15
"andresgilnogues","NatxoCosta",1,0,0,1,2021-11-15
"andresgilnogues","PlasticsEuropES",1,0,0,1,2021-11-15
"andresgilnogues","Rafa_Climentg",1,0,0,1,2021-11-15
"andresgilnogues","RETO16CIMAS",1,0,0,1,2021-11-15
"aneabe","aimplas",1,0,0,1,2021-11-15
"aneabe","aneabe",1,0,0,1,2021-11-15
"Angel_Molinero","aimplas",1,0,0,1,2021-11-15
"Angel_Molinero","CECOes_",1,0,0,1,2021-11-15
"ANIPAC_AC","aimplas",1,0,0,1,2021-11-15
"AnjanaLeon","aimplas",1,0,0,1,2021-11-15
"AnjanaLeon","corifyAF",1,0,0,1,2021-11-15
"AnjanaLeon","Grupo_TSK",1,0,0,1,2021-11-15
"AnjanaLeon","Molecor",1,0,0,1,2021-11-15
"AnjanaLeon","PigCHAMP_Europa",1,0,0,1,2021-11-15
"AnjanaLeon","PlatinoEduca",1,0,0,1,2021-11-15
"AnjanaLeon","skrollerbelt",1,0,0,1,2021-11-15
"AnsiaDe","afaquim_asoc",1,0,0,1,2021-11-15
"AnsiaDe","ANARPLA",1,0,0,1,2021-11-15
"AnsiaDe","ChemSpain",1,0,0,1,2021-11-15
"AnsiaDe","davidorreta",1,0,0,1,2021-11-15
"AnsiaDe","Equiplast",1,0,0,1,2021-11-15
"AnsiaDe","Eurosurfas",1,0,0,1,2021-11-15
"AnsiaDe","expoquimia",1,0,0,1,2021-11-15
"AnsiaDe","Feique_ES",1,0,0,1,2021-11-15
"AnsiaDe","Fira_Barcelona",1,0,0,1,2021-11-15
"AnsiaDe","ForoQyS",1,0,0,1,2021-11-15
"AnsiaDe","FuturEnviro",1,0,0,1,2021-11-15
"AnsiaDe","residuscat",1,0,0,1,2021-11-15
"AnsiaDe","RevistaRETEMA",1,0,0,1,2021-11-15
"apk_ag","aimplas",1,0,0,1,2021-11-15
"apk_ag","ECOS_Standard",1,0,0,1,2021-11-15
"apk_ag","Eunomia_RandC",1,0,0,1,2021-11-15
"apk_ag","EuRIC_Recycling",1,0,0,1,2021-11-15
"apk_ag","pcepeu",1,0,0,1,2021-11-15
"apk_ag","Umweltbundesamt",1,0,0,1,2021-11-15
"apk_ag","umweltstiftung",1,0,0,1,2021-11-15
"Aqua_Radar","aimplas",1,0,0,1,2021-11-15
"AristosInfo","accio_cat",1,0,0,1,2021-11-15
"AristosInfo","aimplas",1,0,0,1,2021-11-15
"AristosInfo","biocat_cat",1,0,0,1,2021-11-15
"AristosInfo","CDTIoficial",1,0,0,1,2021-11-15
"AristosInfo","eencat",1,0,0,1,2021-11-15
"AristosInfo","Eurecat_news",1,0,0,1,2021-11-15
"AristosInfo","H2020_Partner",1,0,0,1,2021-11-15
"AristosInfo","horizonexperts",1,0,0,1,2021-11-15
"AristosInfo","IreneLarroy",1,0,0,1,2021-11-15
"AristosInfo","itene",1,0,0,1,2021-11-15
"AristosInfo","JCGarcia_CDTI",1,0,0,1,2021-11-15
"AristosInfo","jordipietx",1,0,0,1,2021-11-15
"AristosInfo","RosaAriasAlv",1,0,0,1,2021-11-15
"AristosInfo","scibus",1,0,0,1,2021-11-15
"AristosInfo","SorosGabinete",1,0,0,1,2021-11-15
"AristosInfo","talk2much12",1,0,0,1,2021-11-15
"AristosInfo","Wendy_Moreno_EU",1,0,0,1,2021-11-15
"Arturolarena","BelenFranch",1,0,0,1,2021-11-15
"Arturolarena","cdcampo1",1,0,0,1,2021-11-15
"Arturolarena","EFEverde",1,0,0,1,2021-11-15
"Arturolarena","Oceanografic_vl",1,0,0,1,2021-11-15
"Arturolarena","Redit_es",1,0,0,1,2021-11-15
"Arturolarena","trypanus",1,0,0,1,2021-11-15
"ArviInnovapesca","aimplas",1,0,0,1,2021-11-15
"ArviInnovapesca","ArviInnovapesca",1,0,0,1,2021-11-15
"ArviInnovapesca","ecoalf",1,0,0,1,2021-11-15
"ArviInnovapesca","OceanetsProject",1,0,0,1,2021-11-15
"ArviInnovapesca","uvigo",1,0,0,1,2021-11-15
"ArviInnovapesca","Vertidos_Cero",1,0,0,1,2021-11-15
"AsajaNacional","aimplas",1,0,0,1,2021-11-15
"Asefapi_Es","AIDIMME",1,0,0,1,2021-11-15
"Asefapi_Es","AIJU_Tecnologi",1,0,0,1,2021-11-15
"Asefapi_Es","Asefapi_Es",0,0,1,1,2021-11-15
"Asefapi_Es","CIDETEC_",1,0,0,1,2021-11-15
"Asefapi_Es","ensateclab",1,0,0,1,2021-11-15
"Asefapi_Es","INEGIPORTO",1,0,0,1,2021-11-15
"Asefapi_Es","ITAINNOVA",1,0,0,1,2021-11-15
"Asefapi_Es","Neurtek",1,0,0,1,2021-11-15
"Asefapi_Es","tecnalia",1,0,0,1,2021-11-15
"Asesoria_Tefico","aimplas",1,0,0,1,2021-11-15
"Asesoria_Tefico","inbiotecenlared",1,0,0,1,2021-11-15
"Asesoria_Tefico","UAHes",1,0,0,1,2021-11-15
"AseTUB","ANAIP_es",1,0,0,1,2021-11-15
"AseTUB","applus",1,0,0,1,2021-11-15
"AseTUB","emasesa",1,0,0,1,2021-11-15
"ASIAN_Andalucia","aimplas",1,0,0,1,2021-11-15
"ASIAN_Andalucia","CoopsAgroAND",1,0,0,1,2021-11-15
"AsocEyC","ACortinaPantion",1,0,0,1,2021-11-15
"AsocEyC","Correos",1,0,0,1,2021-11-15
"AsocEyC","cristinasancho",1,0,0,1,2021-11-15
"AsocEyC","EspejoPublico",1,0,0,1,2021-11-15
"AsocEyC","foroinserta",1,0,0,1,2021-11-15
"AsocEyC","IKEASpain",1,0,0,1,2021-11-15
"asociacionruvid","CienciaGob",1,0,0,1,2021-11-15
"asociacionruvid","ETSEUV",1,0,0,1,2021-11-15
"asociacionruvid","GlobalOmnium",1,0,0,1,2021-11-15
"asociacionruvid","Grupo_CALAGUA",1,0,0,1,2021-11-15
"asociacionruvid","GVAavi",1,0,0,1,2021-11-15
"asociacionruvid","ibv_org",1,0,0,1,2021-11-15
"asociacionruvid","iiama_upv",1,0,0,1,2021-11-15
"asociacionruvid","ITC_ceramica",1,0,0,1,2021-11-15
"Asturicae","aimplas",1,0,0,1,2021-11-15
"Asturicae","geqo_rseq",1,0,0,1,2021-11-15
"Asturicae","inbiotecenlared",1,0,0,1,2021-11-15
"Asturicae","IQAR_UAH",1,0,0,1,2021-11-15
"Asturicae","lualnu10",1,0,0,1,2021-11-15
"Asturicae","UAHes",1,0,0,1,2021-11-15
"atmbiopro","aacudam",1,0,0,1,2021-11-15
"atmbiopro","AgroBioCluster",1,0,0,1,2021-11-15
"atmbiopro","aimplas",1,0,0,1,2021-11-15
"atmbiopro","BBI2020",1,0,0,1,2021-11-15
"atmbiopro","GenHydro",1,0,0,1,2021-11-15
"atmbiopro","GreenovateEU",1,0,0,1,2021-11-15
"atmbiopro","mi_sustainable",1,0,0,1,2021-11-15
"atmbiopro","RISEProcessum",1,0,0,1,2021-11-15
"atmbiopro","tecnopackaging",1,0,0,1,2021-11-15
"atmbiopro","unlock",1,0,0,1,2021-11-15
"auto_revista","aimplas",1,0,0,1,2021-11-15
"auto_revista","auto_revista",0,0,1,1,2021-11-15
"automatica_","Cicloplast_com",1,0,0,1,2021-11-15
"AutPortValencia","aivp_net",1,0,0,1,2021-11-15
"AutPortValencia","aj_gandia",1,0,0,1,2021-11-15
"AutPortValencia","AjuntamentVLC",1,0,0,1,2021-11-15
"AutPortValencia","AsnavieraVlc",1,0,0,1,2021-11-15
"AutPortValencia","ESPOSecretariat",1,0,0,1,2021-11-15
"AutPortValencia","FValenciaport",1,0,0,1,2021-11-15
"AutPortValencia","GVAagroambient",1,0,0,1,2021-11-15
"AutPortValencia","IMOHQ",1,0,0,1,2021-11-15
"AutPortValencia","propellervlc",1,0,0,1,2021-11-15
"AutPortValencia","PuertosEstado",1,0,0,1,2021-11-15
"AutPortValencia","visitgandia",1,0,0,1,2021-11-15
"AVEmpresarios","AIDIMME",1,0,0,1,2021-11-15
"AVEmpresarios","AIJU_Tecnologi",1,0,0,1,2021-11-15
"AVEmpresarios","aimplas",1,0,0,1,2021-11-15
"AVEmpresarios","ainiatecnologia",1,0,0,1,2021-11-15
"AVEmpresarios","aitex_es",1,0,0,1,2021-11-15
"AVEmpresarios","ibv_org",1,0,0,1,2021-11-15
"AVEmpresarios","InescopTech",1,0,0,1,2021-11-15
"AVEmpresarios","ITC_ceramica",1,0,0,1,2021-11-15
"AVEmpresarios","itene",1,0,0,1,2021-11-15
"AVEmpresarios","itenergia",1,0,0,1,2021-11-15
"AVEmpresarios","ITI_TIC",1,0,0,1,2021-11-15
"AVEmpresarios","Saludes_Ind",1,0,0,1,2021-11-15
"AvepAsociacion","AIDIMME",1,0,0,1,2021-11-15
"AvepAsociacion","InescopTech",1,0,0,1,2021-11-15
"AvepAsociacion","PlasticsEurope",1,0,0,1,2021-11-15
"Azmudeu","PRIMAInnovation",1,0,0,1,2021-11-15
"AZoCleantech","aimplas",1,0,0,1,2021-11-15
"baixauli25","aimplas",1,0,0,1,2021-11-15
"baixauli25","idainature",1,0,0,1,2021-11-15
"baixauli25","Novamont",1,0,0,1,2021-11-15
"Baliht_EU","IFBFFlowBattery",1,0,0,1,2021-11-15
"Baliht_EU","JaviPL19",1,0,0,1,2021-11-15
"barana__","aimplas",1,0,0,1,2021-11-15
"bealopezromero","aimplas",1,0,0,1,2021-11-15
"BeonNAT_H2020","ipbragancaEN",1,0,0,1,2021-11-15
"Berto_Jaramillo","aeioLuz",1,0,0,1,2021-11-15
"Berto_Jaramillo","aimplas",1,0,0,1,2021-11-15
"Berto_Jaramillo","alannaasoc",1,0,0,1,2021-11-15
"Berto_Jaramillo","Berto_Jaramillo",0,0,1,1,2021-11-15
"Berto_Jaramillo","BIOagradables",1,0,0,1,2021-11-15
"Berto_Jaramillo","greenurbandata",1,0,0,1,2021-11-15
"Berto_Jaramillo","VortexCoworking",1,0,0,1,2021-11-15
"Berto_Jaramillo","webmesura",1,0,0,1,2021-11-15
"BIGBANInversion","aimplas",1,0,0,1,2021-11-15
"BIGBANInversion","PCientificoAlic",1,0,0,1,2021-11-15
"BIOnTop_Project","tecnalia",1,0,0,1,2021-11-15
"bioplasticsmag","BIOnTop_Project",1,0,0,1,2021-11-15
"BioSenseRS","aimplas",1,0,0,1,2021-11-15
"BioSenseRS","EU_H2020",1,0,0,1,2021-11-15
"BioSenseRS","GVAivia",1,0,0,1,2021-11-15
"BioSenseRS","Novamont",1,0,0,1,2021-11-15
"BioSenseRS","Terra_i_Xufa",1,0,0,1,2021-11-15
"BioSenseRS","tuc_chania",1,0,0,1,2021-11-15
"BioSenseRS","UA_Universidad",1,0,0,1,2021-11-15
"BIOVAL_es","aitex_es",1,0,0,1,2021-11-15
"BIOVAL_es","BIOVAL_es",1,0,0,1,2021-11-15
"BIOVAL_es","ceei",1,0,0,1,2021-11-15
"BIOVAL_es","ed_cvalenciana",1,0,0,1,2021-11-15
"BioVale_Cluster","aimplas",1,0,0,1,2021-11-15
"BioVale_Cluster","BBI2020",1,0,0,1,2021-11-15
"BioVale_Cluster","biconsortium",1,0,0,1,2021-11-15
"BioVale_Cluster","biobaseddelta",1,0,0,1,2021-11-15
"BioVale_Cluster","CLIB2021",1,0,0,1,2021-11-15
"BioVale_Cluster","fertinagro",1,0,0,1,2021-11-15
"BioVale_Cluster","IARcluster",1,0,0,1,2021-11-15
"BioVale_Cluster","iris_rd",1,0,0,1,2021-11-15
"BioVale_Cluster","irtacat",1,0,0,1,2021-11-15
"BioVale_Cluster","itene",1,0,0,1,2021-11-15
"BioVale_Cluster","ualmeria",1,0,0,1,2021-11-15
"BioVale_Cluster","Unibo",1,0,0,1,2021-11-15
"BlauBenidorm","Actecosl",1,0,0,1,2021-11-15
"BlauBenidorm","aimplas",1,0,0,1,2021-11-15
"BlueMedEU","ACTeon_Env",1,0,0,1,2021-11-15
"BlueMedEU","CEPESCA",1,0,0,1,2021-11-15
"BlueMedEU","CNRsocial_",1,0,0,1,2021-11-15
"BlueMedEU","EBRD",1,0,0,1,2021-11-15
"BlueMedEU","EU_MARE",1,0,0,1,2021-11-15
"BlueMedEU","EUScienceInnov",1,0,0,1,2021-11-15
"BlueMedEU","FederpescaIT",1,0,0,1,2021-11-15
"BlueMedEU","hcmr_gr",1,0,0,1,2021-11-15
"BlueMedEU","MiTE_IT",1,0,0,1,2021-11-15
"BlueMedEU","OGS_IT",1,0,0,1,2021-11-15
"BlueMedEU","RempecNews",1,0,0,1,2021-11-15
"BlueMedEU","Transport_EU",1,0,0,1,2021-11-15
"BlueMedEU","UN_FAO_GFCM",1,0,0,1,2021-11-15
"BlueMedEU","WorldBank",1,0,0,1,2021-11-15
"byproductplace","aimplas",1,0,0,1,2021-11-15
"byproductplace","byproductplace",0,0,1,1,2021-11-15
"byproductplace","Coexphal",1,0,0,1,2021-11-15
"byproductplace","Grupo_Ence",1,0,0,1,2021-11-15
"byproductplace","LuisMiFedz",1,0,0,1,2021-11-15
"cabocla2001","aimplas",1,0,0,1,2021-11-15
"cabocla2001","BASF_ES",1,0,0,1,2021-11-15
"cabocla2001","deborahciencia",1,0,0,1,2021-11-15
"cabocla2001","PlasticsEuropES",1,0,0,1,2021-11-15
"cabocla2001","Repsol",1,0,0,1,2021-11-15
"cabocla2001","SABIC",1,0,0,1,2021-11-15
"cabocla2001","SusChemSpain",1,0,0,1,2021-11-15
"cadecordobaAE","AceiteOlivalle",1,0,0,1,2021-11-15
"cadecordobaAE","aimplas",1,0,0,1,2021-11-15
"Cajamar","aimplas",1,0,0,1,2021-11-15
"Cajamar","CticCita",1,0,0,1,2021-11-15
"campuscomposits","AEMAC_",1,0,0,1,2021-11-15
"campuscomposits","aernnova_usa",1,0,0,1,2021-11-15
"campuscomposits","aimplas",1,0,0,1,2021-11-15
"campuscomposits","AirbusHeli",1,0,0,1,2021-11-15
"campuscomposits","amade_udg",1,0,0,1,2021-11-15
"carlosgarcia_85","aimplas",1,0,0,1,2021-11-15
"CatedraMare","aimplas",1,0,0,1,2021-11-15
"CBIT_upv","aimplas",1,0,0,1,2021-11-15
"cbm_noticias","AceiteOlivalle",1,0,0,1,2021-11-15
"cbm_noticias","aimplas",1,0,0,1,2021-11-15
"ccasellascoll","aimplas",1,0,0,1,2021-11-15
"ccasellascoll","aitex_es",1,0,0,1,2021-11-15
"ccasellascoll","ClusterFPrint",1,0,0,1,2021-11-15
"ccasellascoll","Eurecat_news",1,0,0,1,2021-11-15
"ccasellascoll","itene",1,0,0,1,2021-11-15
"ccasellascoll","Naitec_CT",1,0,0,1,2021-11-15
"ccasellascoll","PT3NEO",1,0,0,1,2021-11-15
"ccasellascoll","SmartEEsEU",1,0,0,1,2021-11-15
"ccasellascoll","tecnalia",1,0,0,1,2021-11-15
"ccasellascoll","UNavarra",1,0,0,1,2021-11-15
"CdeCarnica","Agroforest_JAL",1,0,0,1,2021-11-15
"CdeCarnica","BetoELescamoso",1,0,0,1,2021-11-15
"CdeCarnica","GSCSAL",1,0,0,1,2021-11-15
"CdeCarnica","jhaa2020",1,0,0,1,2021-11-15
"CdeCarnica","juancfa16",1,0,0,1,2021-11-15
"CdeCarnica","rami44618546",1,0,0,1,2021-11-15
"CdeCarnica","sagrosus",1,0,0,1,2021-11-15
"ceeivalencia","AIJU_Tecnologi",1,0,0,1,2021-11-15
"ceeivalencia","caterina_coll",1,0,0,1,2021-11-15
"ceeivalencia","ibv_org",1,0,0,1,2021-11-15
"ceeivalencia","ITC_ceramica",1,0,0,1,2021-11-15
"ceeivalencia","ITI_TIC",1,0,0,1,2021-11-15
"ceeivalencia","Julia_company",1,0,0,1,2021-11-15
"ceeivalencia","rafacliment_",1,0,0,1,2021-11-15
"ceeivalencia","Rebeca_Torro",1,0,0,1,2021-11-15
"CEPplast","3Dnatives_ES",1,0,0,1,2021-11-15
"CEPplast","AEBALL_UPMBALL",1,0,0,1,2021-11-15
"CEPplast","AEMAC_",1,0,0,1,2021-11-15
"CEPplast","AerAutomation",1,0,0,1,2021-11-15
"CEPplast","aiasasociacion",1,0,0,1,2021-11-15
"CEPplast","ANARPLA",1,0,0,1,2021-11-15
"CEPplast","ascameorg",1,0,0,1,2021-11-15
"CEPplast","camarascomercio",1,0,0,1,2021-11-15
"CEPplast","cambrabcn",1,0,0,1,2021-11-15
"CEPplast","ClubMktBcn",1,0,0,1,2021-11-15
"CEPplast","ClusterCICAT",1,0,0,1,2021-11-15
"CEPplast","Digicomexpo",1,0,0,1,2021-11-15
"CEPplast","elpublicistacom",1,0,0,1,2021-11-15
"CEPplast","Envaspres",1,0,0,1,2021-11-15
"CEPplast","eoi",1,0,0,1,2021-11-15
"CEPplast","Eurecat_news",1,0,0,1,2021-11-15
"CEPplast","HispaRob",1,0,0,1,2021-11-15
"CEPplast","industrialesand",1,0,0,1,2021-11-15
"CEPplast","innovallcluster",1,0,0,1,2021-11-15
"CEPplast","int_envase",1,0,0,1,2021-11-15
"CEPplast","IPMARK",1,0,0,1,2021-11-15
"CEPplast","itene",1,0,0,1,2021-11-15
"CEPplast","mincoturgob",1,0,0,1,2021-11-15
"CEPplast","packcluster",1,0,0,1,2021-11-15
"CEPplast","PatronalCecot",1,0,0,1,2021-11-15
"CEPplast","RevistaInfopack",1,0,0,1,2021-11-15
"CEPplast","SECARTYS",1,0,0,1,2021-11-15
"CetecCentro","aimplas",1,0,0,1,2021-11-15
"CetecCentro","ANAIP_es",1,0,0,1,2021-11-15
"chemplastexpo","aimplas",1,0,0,1,2021-11-15
"ChemRecycleNews","aimplas",1,0,0,1,2021-11-15
"Cicloplast_com","ANAIP_es",1,0,0,1,2021-11-15
"Cicloplast_com","FuturEnviro",0,1,0,1,2021-11-15
"ciconiaeduca","AceiteOlivalle",1,0,0,1,2021-11-15
"ciconiaeduca","aimplas",1,0,0,1,2021-11-15
"CIDETEC_","aimplas",1,0,0,1,2021-11-15
"CIMPA_Project","aimplas",1,0,0,1,2021-11-15
"CIMPA_Project","CT_IPC",1,0,0,1,2021-11-15
"CIMPA_Project","EuRIC_Recycling",1,0,0,1,2021-11-15
"CIMPA_Project","TNO_Research",1,0,0,1,2021-11-15
"CIMPA_Project","VTTFinland",1,0,0,1,2021-11-15
"cinea_eu","aqua_lit",1,0,0,1,2021-11-15
"cinea_eu","CiimarUp",1,0,0,1,2021-11-15
"cinea_eu","cinea_eu",0,0,1,1,2021-11-15
"cinea_eu","GeoEnvTech",1,0,0,1,2021-11-15
"cinea_eu","marGnetproject",1,0,0,1,2021-11-15
"cinea_eu","NetTagProject",1,0,0,1,2021-11-15
"Circulariana","aimplas",1,0,0,1,2021-11-15
"Circulariana","stanpa_es",1,0,0,1,2021-11-15
"Club_Excelencia","ColegioSalliver",1,0,0,1,2021-11-15
"Club_Excelencia","GrupoSorollaEdu",1,0,0,1,2021-11-15
"clubcalidadcom","aimplas",1,0,0,1,2021-11-15
"clubcalidadcom","CentrosCex",1,0,0,1,2021-11-15
"clubcalidadcom","corifyAF",1,0,0,1,2021-11-15
"clubcalidadcom","Grupo_TSK",1,0,0,1,2021-11-15
"clubcalidadcom","Molecor",1,0,0,1,2021-11-15
"clubcalidadcom","PigCHAMP_Europa",1,0,0,1,2021-11-15
"clubcalidadcom","PlatinoEduca",1,0,0,1,2021-11-15
"clubcalidadcom","skrollerbelt",1,0,0,1,2021-11-15
"clusaga","aimplas",1,0,0,1,2021-11-15
"clusaga","ainiatecnologia",1,0,0,1,2021-11-15
"ClusterFPrint","CienciaGob",1,0,0,1,2021-11-15
"ClusterFPrint","ClusterFPrint",1,0,0,1,2021-11-15
"ClusterFPrint","Eurecat_news",1,0,0,1,2021-11-15
"ClusterFPrint","itene",1,0,0,1,2021-11-15
"CMplastik","aimplas",1,0,0,1,2021-11-15
"CNTA_CIT","aimplas",1,0,0,1,2021-11-15
"COEXPAN_","ainiatecnologia",1,0,0,1,2021-11-15
"COEXPAN_","Cicloplast_com",1,0,0,1,2021-11-15
"COGITIValencia","GVAeconomia",1,0,0,1,2021-11-15
"COGITIValencia","GVAivace",1,0,0,1,2021-11-15
"COIQCV","aimplas",1,0,0,1,2021-11-15
"Colquimva","aimplas",1,0,0,1,2021-11-15
"ConsejoAgricola","aimplas",1,0,0,1,2021-11-15
"convertronic","aimplas",1,0,0,1,2021-11-15
"CoopsAgroCV","aimplas",1,0,0,1,2021-11-15
"COPEPozoblanco","AceiteOlivalle",1,0,0,1,2021-11-15
"COPEPozoblanco","aimplas",1,0,0,1,2021-11-15
"COPEPozoblanco","CECOes_",1,0,0,1,2021-11-15
"coplasem","aimplas",1,0,0,1,2021-11-15
"Corresponsables","Corresponsables",0,0,1,1,2021-11-15
"CosmeticLatam","CosmeticLatam",0,0,1,1,2021-11-15
"CozAlberto","aimplas",1,0,0,1,2021-11-15
"CRIBE_Biomass","aimplas",1,0,0,1,2021-11-15
"CRIBE_Biomass","TNO_Research",1,0,0,1,2021-11-15
"Crowdhelix","iris_rd",1,0,0,1,2021-11-15
"Crowdhelix","MulticycleP",1,0,0,1,2021-11-15
"CServees","aimplas",1,0,0,1,2021-11-15
"CServees","LinkedIn",1,0,0,1,2021-11-15
"CticCita","aimplas",1,0,0,1,2021-11-15
"CticCita","launioncorp",1,0,0,1,2021-11-15
"CVI_V3","aimplas",1,0,0,1,2021-11-15
"CVI_V3","CORDIS_EU",1,0,0,1,2021-11-15
"CVI_V3","URBANREC_H2020",1,0,0,1,2021-11-15
"DarwinBioprosp","i2sysbio",1,0,0,1,2021-11-15
"davidorreta","Cicloplast_com",1,0,0,1,2021-11-15
"davidorreta","ITC_ceramica",1,0,0,1,2021-11-15
"davidorreta","UV_EG",1,0,0,1,2021-11-15
"deborahciencia","aimplas",1,0,0,1,2021-11-15
"deborahciencia","BASF_ES",1,0,0,1,2021-11-15
"deborahciencia","PlasticsEuropES",1,0,0,1,2021-11-15
"deborahciencia","Repsol",1,0,0,1,2021-11-15
"deborahciencia","SABIC",1,0,0,1,2021-11-15
"detectormadrid","aimplas",1,0,0,1,2021-11-15
"DGreenblogger","BIOnTop_Project",1,0,0,1,2021-11-15
"DigitalEscudo","aimplas",1,0,0,1,2021-11-15
"DigitalEscudo","GVAivace",1,0,0,1,2021-11-15
"DigitalEscudo","ITI_TIC",1,0,0,1,2021-11-15
"dipMurcia","aimplas",1,0,0,1,2021-11-15
"dipMurcia","artsolut",1,0,0,1,2021-11-15
"dipMurcia","EssentraPackES",1,0,0,1,2021-11-15
"dipMurcia","Foro_READ",1,0,0,1,2021-11-15
"dipMurcia","itene",1,0,0,1,2021-11-15
"dipMurcia","Packnet_",1,0,0,1,2021-11-15
"DominoPrint_ES","ANAIP_es",1,0,0,1,2021-11-15
"DominoPrint_ES","Cicloplast_com",1,0,0,1,2021-11-15
"DominoPrint_ES","esplasticos",1,0,0,1,2021-11-15
"DominoPrint_ES","PlasticsEurope",1,0,0,1,2021-11-15
"DominoPrint_Mx","esplasticos",1,0,0,1,2021-11-15
"DominoPrint_Mx","plastic_museum",1,0,0,1,2021-11-15
"DominoPrint_Mx","RPM_Plasticos",1,0,0,1,2021-11-15
"DriadeSM","aimplas",1,0,0,1,2021-11-15
"DriadeSM","f_f_ambiental",1,0,0,1,2021-11-15
"DriadeSM","Suruscircular",1,0,0,1,2021-11-15
"DulcesNoticias","ainiatecnologia",1,0,0,1,2021-11-15
"DulcesNoticias","ANAIP_es",1,0,0,1,2021-11-15
"DulcesNoticias","ANARPLA",1,0,0,1,2021-11-15
"DulcesNoticias","danone_es",1,0,0,1,2021-11-15
"DulcesNoticias","faerchgroup",1,0,0,1,2021-11-15
"DulcesNoticias","Nestle_es",1,0,0,1,2021-11-15
"DulcesNoticias","UV_EG",1,0,0,1,2021-11-15
"ECAndalucia","20m",1,0,0,1,2021-11-15
"ECCA_Sevilla","ACCIONA",1,0,0,1,2021-11-15
"ECCA_Sevilla","aimplas",1,0,0,1,2021-11-15
"ECCA_Sevilla","ECCA_Sevilla",0,1,0,1,2021-11-15
"ECCA_Sevilla","FundacionRepsol",1,0,0,1,2021-11-15
"ECCA_Sevilla","knaufes",1,0,0,1,2021-11-15
"ECCA_Sevilla","WTS_Horizon",1,0,0,1,2021-11-15
"EcoconstruMag","AIDIMME",1,0,0,1,2021-11-15
"EcoconstruMag","ITCCANARIAS",1,0,0,1,2021-11-15
"Economia_3","ana_gil_lop",1,0,0,1,2021-11-15
"Economia_3","ANAIP_es",1,0,0,1,2021-11-15
"Economia_3","AvepAsociacion",1,0,0,1,2021-11-15
"Economia_3","GVAavi",1,0,0,1,2021-11-15
"Economia_3","IISLaFe",1,0,0,1,2021-11-15
"Economia_3","Industrias_TAYG",1,0,0,1,2021-11-15
"Economia_3","itmupv",1,0,0,1,2021-11-15
"Economia_3","ITQ_UPVCSIC",1,0,0,1,2021-11-15
"EcoxyProject","Avantium",1,0,0,1,2021-11-15
"EcoxyProject","BBI2020",1,0,0,1,2021-11-15
"EcoxyProject","Centexbel",1,0,0,1,2021-11-15
"EcoxyProject","CIDETEC_",1,0,0,1,2021-11-15
"EcoxyProject","crfiat",1,0,0,1,2021-11-15
"EcoxyProject","EcoxyProject",0,0,1,1,2021-11-15
"EcoxyProject","FraunhoferICT",1,0,0,1,2021-11-15
"EcoxyProject","SP_Polymers",1,0,0,1,2021-11-15
"ed_cvalenciana","aimplas",1,0,0,1,2021-11-15
"ed_cvalenciana","BIOVAL_es",1,0,0,1,2021-11-15
"ed_cvalenciana","carlosidai",1,0,0,1,2021-11-15
"ed_cvalenciana","ceeivalencia",1,0,0,1,2021-11-15
"ed_cvalenciana","emprenemjunts",1,0,0,1,2021-11-15
"ed_cvalenciana","itenergia",1,0,0,1,2021-11-15
"EDICIONESSIBILA","AIJU_Tecnologi",1,0,0,1,2021-11-15
"EDICIONESSIBILA","aitex_es",1,0,0,1,2021-11-15
"EDICIONESSIBILA","generalitat",1,0,0,1,2021-11-15
"EDICIONESSIBILA","GVAivace",1,0,0,1,2021-11-15
"EDICIONESSIBILA","GVAlabora",1,0,0,1,2021-11-15
"EditaOla","aimplas",1,0,0,1,2021-11-15
"EditaOla","Arturolarena",1,0,0,1,2021-11-15
"EditaOla","BelenFranch",1,0,0,1,2021-11-15
"edpemo","aimplas",1,0,0,1,2021-11-15
"edpemo","AvepAsociacion",1,0,0,1,2021-11-15
"edpemo","Avia_automocion",1,0,0,1,2021-11-15
"edpemo","CEPplast",1,0,0,1,2021-11-15
"edpemo","HP",1,0,0,1,2021-11-15
"edpemo","IAM3DHUB",1,0,0,1,2021-11-15
"edpemo","industry_arena",1,0,0,1,2021-11-15
"edpemo","PlasticsEuropES",1,0,0,1,2021-11-15
"Educanced","aimplas",1,0,0,1,2021-11-15
"EduTorregrosa12","aimplas",1,0,0,1,2021-11-15
"EduTorregrosa12","corifyAF",1,0,0,1,2021-11-15
"EduTorregrosa12","Grupo_TSK",1,0,0,1,2021-11-15
"EduTorregrosa12","Molecor",1,0,0,1,2021-11-15
"EduTorregrosa12","PigCHAMP_Europa",1,0,0,1,2021-11-15
"EduTorregrosa12","PlatinoEduca",1,0,0,1,2021-11-15
"EEljarrat","aimplas",1,0,0,1,2021-11-15
"EFE_CValenciana","ainiatecnologia",1,0,0,1,2021-11-15
"EFE_CValenciana","itenergia",1,0,0,1,2021-11-15
"EFE_CValenciana","Redit_es",1,0,0,1,2021-11-15
"Efeagro","aimplas",1,0,0,1,2021-11-15
"Efeagro","idainature",1,0,0,1,2021-11-15
"EFEcomunica","itenergia",1,0,0,1,2021-11-15
"EIPAGRI_SP","AceiteOlivalle",1,0,0,1,2021-11-15
"EIPAGRI_SP","aimplas",1,0,0,1,2021-11-15
"eldiarioclm","aimplas",1,0,0,1,2021-11-15
"eldiarioclm","inbiotecenlared",1,0,0,1,2021-11-15
"eldiarioclm","MartaEGMosquera",1,0,0,1,2021-11-15
"eldiarioclm","UAHes",1,0,0,1,2021-11-15
"elEconomistaCV","ainiatecnologia",1,0,0,1,2021-11-15
"ElQuincenal","AceiteOlivalle",1,0,0,1,2021-11-15
"ElQuincenal","aimplas",1,0,0,1,2021-11-15
"EmballagesMag","aimplas",1,0,0,1,2021-11-15
"EmballagesMag","CT_IPC",1,0,0,1,2021-11-15
"EmballagesMag","Leygatech1",1,0,0,1,2021-11-15
"EmballagesMag","Paprec_Group",1,0,0,1,2021-11-15
"EmballagesMag","pellencst",1,0,0,1,2021-11-15
"EmballagesMag","VTTFinland",1,0,0,1,2021-11-15
"emprenemjunts","aganovagrupo",1,0,0,1,2021-11-15
"emprenemjunts","Betelgeux_es",1,0,0,1,2021-11-15
"emprenemjunts","ceei",1,0,0,1,2021-11-15
"emprenemjunts","EosOrbital",1,0,0,1,2021-11-15
"emprenemjunts","FEDACOVA_VLC",1,0,0,1,2021-11-15
"emprenemjunts","fundeun",1,0,0,1,2021-11-15
"emprenemjunts","GlobalOmnium",1,0,0,1,2021-11-15
"emprenemjunts","GoHubTech",1,0,0,1,2021-11-15
"emprenemjunts","GVAavi",1,0,0,1,2021-11-15
"emprenemjunts","GVAddigital",1,0,0,1,2021-11-15
"emprenemjunts","iata_csic",1,0,0,1,2021-11-15
"emprenemjunts","LasNavesINN",1,0,0,1,2021-11-15
"emprenemjunts","lasprovincias",1,0,0,1,2021-11-15
"emprenemjunts","LinkenerSpain",1,0,0,1,2021-11-15
"emprenemjunts","parccientificuv",1,0,0,1,2021-11-15
"emprenemjunts","Periodistas360",1,0,0,1,2021-11-15
"emprenemjunts","sistema_doeet",1,0,0,1,2021-11-15
"emprenemjunts","UV_EG",1,0,0,1,2021-11-15
"emprenemjunts","valgenetics",1,0,0,1,2021-11-15
"EMSUR_","aimplas",1,0,0,1,2021-11-15
"EMSUR_","EMSUR_",1,0,0,1,2021-11-15
"entidadPTV","SagredoMarco",0,1,0,1,2021-11-15
"EPCValenciana","aimplas",1,0,0,1,2021-11-15
"EPCValenciana","GVAivace",1,0,0,1,2021-11-15
"EPPM_Magazine","BerryGlobalInc",1,0,0,1,2021-11-15
"EPPM_Magazine","breathe_99",1,0,0,1,2021-11-15
"EPPM_Magazine","CarmofProject",1,0,0,1,2021-11-15
"EPPM_Magazine","InterplasUK",1,0,0,1,2021-11-15
"EPPM_Magazine","kpGroup_",1,0,0,1,2021-11-15
"EPPM_Magazine","LeistritzCorp",1,0,0,1,2021-11-15
"EPPM_Magazine","SABIC",1,0,0,1,2021-11-15
"EPPM_Magazine","TiniusOlsen1",1,0,0,1,2021-11-15
"EPPM_Magazine","TNO_Research",1,0,0,1,2021-11-15
"EPPM_Magazine","TOMRAGroup",1,0,0,1,2021-11-15
"Equiplast","AMETIC_es",1,0,0,1,2021-11-15
"Equiplast","Ascamm_Gremi",1,0,0,1,2021-11-15
"Equiplast","asegre01",1,0,0,1,2021-11-15
"Equiplast","BASF_ES",1,0,0,1,2021-11-15
"Equiplast","CEP",1,0,0,1,2021-11-15
"Equiplast","CEPplast",1,0,0,1,2021-11-15
"Equiplast","CienciaGob",1,0,0,1,2021-11-15
"Equiplast","circ_economy",1,0,0,1,2021-11-15
"Equiplast","deborahciencia",1,0,0,1,2021-11-15
"Equiplast","eRecicla",1,0,0,1,2021-11-15
"Equiplast","FidaMc",1,0,0,1,2021-11-15
"Equiplast","mincoturgob",1,0,0,1,2021-11-15
"Equiplast","mitecogob",1,0,0,1,2021-11-15
"Equiplast","PT3NEO",1,0,0,1,2021-11-15
"Equiplast","Repsol",1,0,0,1,2021-11-15
"Equiplast","SABIC",1,0,0,1,2021-11-15
"Equiplast","SusChemSpain",1,0,0,1,2021-11-15
"espaitec","aimplas",1,0,0,1,2021-11-15
"espaitec","innotransfer",1,0,0,1,2021-11-15
"esplasticos","20m",1,0,0,1,2021-11-15
"esplasticos","ANAIP_es",1,0,0,1,2021-11-15
"esplasticos","ANARPLA",1,0,0,1,2021-11-15
"esplasticos","AvepAsociacion",1,0,0,1,2021-11-15
"esplasticos","PlasticsEuropES",1,0,0,1,2021-11-15
"esplasticos","TeknikerOficial",1,0,0,1,2021-11-15
"Eternal_Energy_","aimplas",1,0,0,1,2021-11-15
"Eternal_Energy_","itenergia",1,0,0,1,2021-11-15
"Eternal_Energy_","Per_Energia",1,0,0,1,2021-11-15
"ETSEUV","aimplas",1,0,0,1,2021-11-15
"ETSEUV","ETSEUV",0,0,1,1,2021-11-15
"ETSEUV","GlobalOmnium",1,0,0,1,2021-11-15
"ETSEUV","Grupo_CALAGUA",1,0,0,1,2021-11-15
"EUBioplastics","BBI2020",1,0,0,1,2021-11-15
"EUBioplastics","BIOnTop_Project",1,0,0,1,2021-11-15
"EUBioplastics","EU_H2020",1,0,0,1,2021-11-15
"EUBioplastics","OceanetsProject",1,0,0,1,2021-11-15
"EURO_FUNDING","aimplas",1,0,0,1,2021-11-15
"eurocarne","ANAIP_es",1,0,0,1,2021-11-15
"eurocarne","PlasticsEuropES",1,0,0,1,2021-11-15
"Eurofach","aimplas",1,0,0,1,2021-11-15
"Eurosurfas","AMETIC_es",1,0,0,1,2021-11-15
"Eurosurfas","asegre01",1,0,0,1,2021-11-15
"Eurosurfas","FidaMc",1,0,0,1,2021-11-15
"Eurosurfas","PT3NEO",1,0,0,1,2021-11-15
"Eurosurfas","tecnalia",1,0,0,1,2021-11-15
"evaquie","aimplas",1,0,0,1,2021-11-15
"evaquie","rodysuarez",1,0,0,1,2021-11-15
"excedentesolar","aimplas",1,0,0,1,2021-11-15
"excedentesolar","BASF_ES",1,0,0,1,2021-11-15
"excedentesolar","deborahciencia",1,0,0,1,2021-11-15
"excedentesolar","PlasticsEuropES",1,0,0,1,2021-11-15
"excedentesolar","Repsol",1,0,0,1,2021-11-15
"excedentesolar","SABIC",1,0,0,1,2021-11-15
"excedentesolar","SusChemSpain",1,0,0,1,2021-11-15
"expoquimia","AMETIC_es",1,0,0,1,2021-11-15
"expoquimia","asegre01",1,0,0,1,2021-11-15
"expoquimia","BASF_ES",1,0,0,1,2021-11-15
"expoquimia","deborahciencia",1,0,0,1,2021-11-15
"expoquimia","FidaMc",1,0,0,1,2021-11-15
"expoquimia","PlasticsEuropES",1,0,0,1,2021-11-15
"expoquimia","PT3NEO",1,0,0,1,2021-11-15
"expoquimia","Repsol",1,0,0,1,2021-11-15
"expoquimia","SABIC",1,0,0,1,2021-11-15
"expoquimia","SusChemSpain",1,0,0,1,2021-11-15
"expoquimia","tecnalia",1,0,0,1,2021-11-15
"EySMunicipales","aimplas",1,0,0,1,2021-11-15
"FabricaPodcast","AIDIMME",1,0,0,1,2021-11-15
"FabricaPodcast","AIJU_Tecnologi",1,0,0,1,2021-11-15
"FabricaPodcast","aimplas",1,0,0,1,2021-11-15
"FabricaPodcast","ainiatecnologia",1,0,0,1,2021-11-15
"FabricaPodcast","aitex_es",1,0,0,1,2021-11-15
"FabricaPodcast","ibv_org",1,0,0,1,2021-11-15
"FabricaPodcast","InescopTech",1,0,0,1,2021-11-15
"FabricaPodcast","itene",1,0,0,1,2021-11-15
"FabricaPodcast","ITI_TIC",1,0,0,1,2021-11-15
"FabricaPodcast","Redit_es",1,0,0,1,2021-11-15
"fadiplastsl","AIDIMME",1,0,0,1,2021-11-15
"fadiplastsl","InescopTech",1,0,0,1,2021-11-15
"FarrellyMitchel","aacudam",1,0,0,1,2021-11-15
"FarrellyMitchel","AgroBioCluster",1,0,0,1,2021-11-15
"FarrellyMitchel","aimplas",1,0,0,1,2021-11-15
"FarrellyMitchel","CIDETEC_",1,0,0,1,2021-11-15
"FarrellyMitchel","FarrellyMitchel",0,1,0,1,2021-11-15
"FarrellyMitchel","GenHydro",1,0,0,1,2021-11-15
"FarrellyMitchel","GreenovateEU",1,0,0,1,2021-11-15
"FarrellyMitchel","mi_sustainable",1,0,0,1,2021-11-15
"FarrellyMitchel","RISEProcessum",1,0,0,1,2021-11-15
"FCalidad","GVAavi",1,0,0,1,2021-11-15
"FCalidad","IISLaFe",1,0,0,1,2021-11-15
"FCalidad","Industrias_TAYG",1,0,0,1,2021-11-15
"FCalidad","itmupv",1,0,0,1,2021-11-15
"FCalidad","tecnalia",1,0,0,1,2021-11-15
"FConexus","aimplas",1,0,0,1,2021-11-15
"FEDACOVA_VLC","aimplas",1,0,0,1,2021-11-15
"FEDACOVA_VLC","ainiatecnologia",1,0,0,1,2021-11-15
"Fedit","zeus_packaging",1,0,0,1,2021-11-15
"Feique_ES","aimplas",1,0,0,1,2021-11-15
"Feique_ES","BASF_ES",1,0,0,1,2021-11-15
"Feique_ES","deborahciencia",1,0,0,1,2021-11-15
"Feique_ES","PlasticsEuropES",1,0,0,1,2021-11-15
"Feique_ES","Repsol",1,0,0,1,2021-11-15
"Feique_ES","SABIC",1,0,0,1,2021-11-15
"Feique_ES","SusChemSpain",1,0,0,1,2021-11-15
"Ferfollos","aimplas",1,0,0,1,2021-11-15
"feriaecofira","ecoticiasRED",1,0,0,1,2021-11-15
"feriaecofira","GVAivace",1,0,0,1,2021-11-15
"feriaecofira","UV_EG",1,0,0,1,2021-11-15
"Fernando_Ca_63","AIDIMME",1,0,0,1,2021-11-15
"Fernando_Ca_63","entidadPTV",1,0,0,1,2021-11-15
"Fernando_Ca_63","InescopTech",1,0,0,1,2021-11-15
"fertinagro","aimplas",1,0,0,1,2021-11-15
"Fesord","aimplas",1,0,0,1,2021-11-15
"ffe_es","Adif_es",1,0,0,1,2021-11-15
"ffe_es","AgEInves",1,0,0,1,2021-11-15
"ffe_es","ArcelorMittal",1,0,0,1,2021-11-15
"ffe_es","La_UPM",1,0,0,1,2021-11-15
"ffe_es","mitmagob",1,0,0,1,2021-11-15
"ffe_es","Shift2Rail_JU",1,0,0,1,2021-11-15
"ffe_es","TalgoGroup",1,0,0,1,2021-11-15
"ffe_es","tecnalia",1,0,0,1,2021-11-15
"fgirona","aimplas",1,0,0,1,2021-11-15
"fgirona","Benihort",1,0,0,1,2021-11-15
"fgirona","CoopsAgroCV",1,0,0,1,2021-11-15
"fgirona","GVAavi",1,0,0,1,2021-11-15
"fgirona","IBMCP",1,0,0,1,2021-11-15
"FGlobalis","ajvila",1,0,0,1,2021-11-15
"FGlobalis","CDTIoficial",1,0,0,1,2021-11-15
"FGlobalis","dipcas",1,0,0,1,2021-11-15
"FIDAMC_","AEMAC_",1,0,0,1,2021-11-15
"FIDAMC_","Eurecat_news",1,0,0,1,2021-11-15
"FIDAMC_","FIDAMC_",0,1,0,1,2021-11-15
"FIDAMC_","Fira_Barcelona",1,0,0,1,2021-11-15
"fihguv","GVAsanitat",1,0,0,1,2021-11-15
"fihguv","HGUVALENCIA",0,1,0,1,2021-11-15
"fihguv","IRTIC_UV",1,0,0,1,2021-11-15
"fihguv","UPV",1,0,0,1,2021-11-15
"FlotantProject","FutureFibres",1,0,0,1,2021-11-15
"FlotantProject","GranCanariaCab",1,0,0,1,2021-11-15
"FlotantProject","Renewables_UoE",1,0,0,1,2021-11-15
"FlotantProject","RWTH",1,0,0,1,2021-11-15
"FlotantProject","TfiMarine",1,0,0,1,2021-11-15
"food_retail","esplasticos",1,0,0,1,2021-11-15
"Food4LifeSPAIN","CticCita",1,0,0,1,2021-11-15
"Food4LifeSPAIN","PKF_INNCOME",1,0,0,1,2021-11-15
"Food4LifeSPAIN","Sealed_Air",1,0,0,1,2021-11-15
"Food4LifeSPAIN","UABBarcelona",1,0,0,1,2021-11-15
"FoodTechBiz","aimplas",1,0,0,1,2021-11-15
"ForoQyS","Airbus",1,0,0,1,2021-11-15
"ForoQyS","Cefic",1,0,0,1,2021-11-15
"ForoQyS","deborahciencia",1,0,0,1,2021-11-15
"ForoQyS","foretica",1,0,0,1,2021-11-15
"ForoQyS","GVAivace",1,0,0,1,2021-11-15
"ForoQyS","Pascual",1,0,0,1,2021-11-15
"ForoQyS","ternua",1,0,0,1,2021-11-15
"ForoQyS","UPV",1,0,0,1,2021-11-15
"FranoisStryker1","AErasmusproject",0,1,0,1,2021-11-15
"FranoisStryker1","aimplas",1,0,0,1,2021-11-15
"FranoisStryker1","Jobsatskills",1,0,0,1,2021-11-15
"fruittoday","ADNAgroFood",1,0,0,1,2021-11-15
"fruittoday","Cajamar",1,0,0,1,2021-11-15
"fruittoday","esplasticos",1,0,0,1,2021-11-15
"fruittoday","frutasloscursos",1,0,0,1,2021-11-15
"fruittoday","fTROPS",1,0,0,1,2021-11-15
"fruittoday","launioncorp",1,0,0,1,2021-11-15
"fruittoday","mitecogob",1,0,0,1,2021-11-15
"fruittoday","RG_tropical",1,0,0,1,2021-11-15
"Fryjole","aimplas",1,0,0,1,2021-11-15
"Fryjole","AMIQGreenChem",1,0,0,1,2021-11-15
"Fryjole","AseBio",1,0,0,1,2021-11-15
"Fryjole","AVEBIOM",1,0,0,1,2021-11-15
"Fryjole","bioplat",1,0,0,1,2021-11-15
"Fryjole","CienciaGob",1,0,0,1,2021-11-15
"Fryjole","FEBiotec",1,0,0,1,2021-11-15
"Fryjole","SusChemSpain",1,0,0,1,2021-11-15
"Fund_Diversidad","EU_Commission",1,0,0,1,2021-11-15
"Fund_Diversidad","EU_Justice",1,0,0,1,2021-11-15
"Fund_Diversidad","helenadalli",1,0,0,1,2021-11-15
"FuturEnviro","aebigspain",1,0,0,1,2021-11-15
"FuturEnviro","AIDIMME",1,0,0,1,2021-11-15
"FuturEnviro","airesaslu",1,0,0,1,2021-11-15
"FuturEnviro","aitiip",1,0,0,1,2021-11-15
"FuturEnviro","ANAIP_es",1,0,0,1,2021-11-15
"FuturEnviro","aqualia",1,0,0,1,2021-11-15
"FuturEnviro","AvepAsociacion",1,0,0,1,2021-11-15
"FuturEnviro","BASF_ES",1,0,0,1,2021-11-15
"FuturEnviro","CIDETEC_",1,0,0,1,2021-11-15
"FuturEnviro","ecodigestion",1,0,0,1,2021-11-15
"FuturEnviro","esplasticos",1,0,0,1,2021-11-15
"FuturEnviro","EU_ENV",1,0,0,1,2021-11-15
"FuturEnviro","eucobat",1,0,0,1,2021-11-15
"FuturEnviro","FCC_MA",1,0,0,1,2021-11-15
"FuturEnviro","fempcomunica",1,0,0,1,2021-11-15
"FuturEnviro","InescopTech",1,0,0,1,2021-11-15
"FuturEnviro","ITC_ceramica",1,0,0,1,2021-11-15
"FuturEnviro","Molecor",1,0,0,1,2021-11-15
"FuturEnviro","OHBasanta",1,0,0,1,2021-11-15
"FuturEnviro","paperChain_pro",1,0,0,1,2021-11-15
"FuturEnviro","picvisa",1,0,0,1,2021-11-15
"FuturEnviro","PlasticsEuropES",1,0,0,1,2021-11-15
"FuturEnviro","PTARElSalitre",1,0,0,1,2021-11-15
"FuturEnviro","recyclia",1,0,0,1,2021-11-15
"FuturEnviro","Repsol",1,0,0,1,2021-11-15
"FuturEnviro","suezES",1,0,0,1,2021-11-15
"FuturEnviro","TNO_Research",1,0,0,1,2021-11-15
"FuturEnviro","UV_EG",1,0,0,1,2021-11-15
"FValenciaport","aimplas",1,0,0,1,2021-11-15
"gacetadental","aimplas",1,0,0,1,2021-11-15
"gacetadental","ibv_org",1,0,0,1,2021-11-15
"garcia_saludes","AIDIMME",1,0,0,1,2021-11-15
"garcia_saludes","AIJU_Tecnologi",1,0,0,1,2021-11-15
"garcia_saludes","aimplas",1,0,0,1,2021-11-15
"garcia_saludes","ainiatecnologia",1,0,0,1,2021-11-15
"garcia_saludes","aitex_es",1,0,0,1,2021-11-15
"garcia_saludes","ibv_org",1,0,0,1,2021-11-15
"garcia_saludes","InescopTech",1,0,0,1,2021-11-15
"garcia_saludes","ITC_ceramica",1,0,0,1,2021-11-15
"garcia_saludes","itene",1,0,0,1,2021-11-15
"garcia_saludes","itenergia",1,0,0,1,2021-11-15
"garcia_saludes","ITI_TIC",1,0,0,1,2021-11-15
"garcia_saludes","Saludes_Ind",1,0,0,1,2021-11-15
"gastronomiayfit","aimplas",1,0,0,1,2021-11-15
"gastronomiayfit","gastronomiayfit",0,0,1,1,2021-11-15
"GBDC78","aimplas",1,0,0,1,2021-11-15
"GBDC78","Benkei_Fr",1,0,0,1,2021-11-15
"GBDC78","CT_IPC",1,0,0,1,2021-11-15
"GBDC78","filigrade",1,0,0,1,2021-11-15
"GBDC78","PellencGroup",1,0,0,1,2021-11-15
"GBDC78","Pollutec",1,0,0,1,2021-11-15
"GBDC78","ProspexInst",1,0,0,1,2021-11-15
"gbelenguer","AIDIMME",1,0,0,1,2021-11-15
"gbelenguer","AIJU_Tecnologi",1,0,0,1,2021-11-15
"gbelenguer","aimplas",1,0,0,1,2021-11-15
"gbelenguer","ainiatecnologia",1,0,0,1,2021-11-15
"gbelenguer","aitex_es",1,0,0,1,2021-11-15
"gbelenguer","asociacionruvid",1,0,0,1,2021-11-15
"gbelenguer","AVEmpresarios",1,0,0,1,2021-11-15
"gbelenguer","emparmbonafe",1,0,0,1,2021-11-15
"gbelenguer","Fedit",1,0,0,1,2021-11-15
"gbelenguer","FundacionETNOR",1,0,0,1,2021-11-15
"gbelenguer","GVAavi",1,0,0,1,2021-11-15
"gbelenguer","GVAddigital",1,0,0,1,2021-11-15
"gbelenguer","GVAinnova",1,0,0,1,2021-11-15
"gbelenguer","InescopTech",1,0,0,1,2021-11-15
"gbelenguer","ITC_ceramica",1,0,0,1,2021-11-15
"gbelenguer","itenergia",1,0,0,1,2021-11-15
"gbelenguer","PremiosReiJaume",1,0,0,1,2021-11-15
"gbelenguer","RectoraUA",1,0,0,1,2021-11-15
"gbelenguer","Redit_es",1,0,0,1,2021-11-15
"gbelenguer","UA_Universidad",1,0,0,1,2021-11-15
"generalitat","aimplas",1,0,0,1,2021-11-15
"generalitat","GlobalOmnium",1,0,0,1,2021-11-15
"generalitat","GVAavi",1,0,0,1,2021-11-15
"generalitat","lifesequencing",1,0,0,1,2021-11-15
"generalitat","UV_EG",1,0,0,1,2021-11-15
"GimenoGroup","aimplas",1,0,0,1,2021-11-15
"GimenoGroup","geqo_rseq",1,0,0,1,2021-11-15
"GimenoGroup","inbiotecenlared",1,0,0,1,2021-11-15
"GimenoGroup","IQAR_UAH",1,0,0,1,2021-11-15
"GimenoGroup","lualnu10",1,0,0,1,2021-11-15
"GimenoGroup","UAHes",1,0,0,1,2021-11-15
"GoHubTech","angelramire",1,0,0,1,2021-11-15
"GoHubTech","GoHubTech",0,0,1,1,2021-11-15
"GoHubTech","JuanPeaIbaez2",1,0,0,1,2021-11-15
"GoHubTech","pepesiega",1,0,0,1,2021-11-15
"Grupo_Soledad","aimplas",1,0,0,1,2021-11-15
"Grupo_Soledad","BancoSabadell",1,0,0,1,2021-11-15
"Grupo_Soledad","levante_emv",1,0,0,1,2021-11-15
"grupoenercoop","aimplas",1,0,0,1,2021-11-15
"grupoenercoop","itenergia",1,0,0,1,2021-11-15
"GrupoTHM","ainiatecnologia",1,0,0,1,2021-11-15
"GrupoTorrent","aimplas",1,0,0,1,2021-11-15
"GrupoTorrent","ANAIP_es",1,0,0,1,2021-11-15
"GrupoTorrent","ANARPLA",1,0,0,1,2021-11-15
"GrupoTorrent","AvepAsociacion",1,0,0,1,2021-11-15
"GrupoTorrent","Cicloplast_com",1,0,0,1,2021-11-15
"GrupoTorrent","esplasticos",1,0,0,1,2021-11-15
"GrupoTorrent","PlasticsEuropES",1,0,0,1,2021-11-15
"GuiaJuguete","aimplas",1,0,0,1,2021-11-15
"GuiaJuguete","Oceanografic_vl",1,0,0,1,2021-11-15
"GVAavi","Cooplliria",1,0,0,1,2021-11-15
"GVAavi","CSIC",0,1,0,1,2021-11-15
"GVAavi","FuturEnviro",0,1,0,1,2021-11-15
"GVAavi","informacion_es",1,0,0,1,2021-11-15
"GVAavi","UA_Universidad",1,0,0,1,2021-11-15
"GVAeconomia","CentrosCex",1,0,0,1,2021-11-15
"GVAeconomia","GVAeconomia",0,0,1,1,2021-11-15
"GVAeconomia","Julia_company",1,0,0,1,2021-11-15
"GVAeconomia","skrollerbelt",1,0,0,1,2021-11-15
"GVAinnova","generalitat",1,0,0,1,2021-11-15
"GVAivace","AIJU_Tecnologi",1,0,0,1,2021-11-15
"GVAivace","aitex_es",1,0,0,1,2021-11-15
"GVAivace","BancoSabadell",1,0,0,1,2021-11-15
"GVAivace","casasinhaus",1,0,0,1,2021-11-15
"GVAivace","CDTIoficial",1,0,0,1,2021-11-15
"GVAivace","escamilla50",1,0,0,1,2021-11-15
"GVAivace","gbelenguer",1,0,0,1,2021-11-15
"GVAivace","GVAeconomia",0,1,0,1,2021-11-15
"GVAivace","HorizonteEuropa",1,0,0,1,2021-11-15
"GVAivace","itenergia",1,0,0,1,2021-11-15
"GVAivace","ITI_TIC",1,0,0,1,2021-11-15
"GVAivace","microempresa",1,0,0,1,2021-11-15
"GVAivace","RebecaOntinyent",1,0,0,1,2021-11-15
"GVAivace","Sebastia_Jordi",1,0,0,1,2021-11-15
"GVAportaveu","AIDIMME",1,0,0,1,2021-11-15
"GVAportaveu","AIJU_Tecnologi",1,0,0,1,2021-11-15
"GVAportaveu","aimplas",1,0,0,1,2021-11-15
"GVAportaveu","aitex_es",1,0,0,1,2021-11-15
"GVAportaveu","GVAeconomia",1,0,0,1,2021-11-15
"GVAportaveu","GVAlabora",1,0,0,1,2021-11-15
"GVAportaveu","InescopTech",1,0,0,1,2021-11-15
"GVAvicepres2n","AIDIMME",1,0,0,1,2021-11-15
"GVAvicepres2n","AIJU_Tecnologi",1,0,0,1,2021-11-15
"GVAvicepres2n","aimplas",1,0,0,1,2021-11-15
"GVAvicepres2n","laurasfrances",1,0,0,1,2021-11-15
"GVAvicepres2n","matarredona_nur",1,0,0,1,2021-11-15
"GVAvicepres2n","Redit_es",1,0,0,1,2021-11-15
"H2020_Partner","accio_cat",1,0,0,1,2021-11-15
"H2020_Partner","aimplas",1,0,0,1,2021-11-15
"H2020_Partner","AristosInfo",1,0,0,1,2021-11-15
"H2020_Partner","biocat_cat",1,0,0,1,2021-11-15
"H2020_Partner","CDTIoficial",1,0,0,1,2021-11-15
"H2020_Partner","eencat",1,0,0,1,2021-11-15
"H2020_Partner","Eurecat_news",1,0,0,1,2021-11-15
"H2020_Partner","horizonexperts",1,0,0,1,2021-11-15
"H2020_Partner","itene",1,0,0,1,2021-11-15
"H2020_Partner","JCGarcia_CDTI",1,0,0,1,2021-11-15
"H2020_Partner","jordipietx",1,0,0,1,2021-11-15
"H2020_Partner","RosaAriasAlv",1,0,0,1,2021-11-15
"H2020_Partner","scibus",1,0,0,1,2021-11-15
"H2020_Partner","SorosGabinete",1,0,0,1,2021-11-15
"H2020_Partner","Wendy_Moreno_EU",1,0,0,1,2021-11-15
"HABRILAN","Airbus",1,0,0,1,2021-11-15
"HABRILAN","AvepAsociacion",1,0,0,1,2021-11-15
"HABRILAN","CompositesQuim",1,0,0,1,2021-11-15
"HABRILAN","CompositesSpain",1,0,0,1,2021-11-15
"HABRILAN","DANOBATGROUP",1,0,0,1,2021-11-15
"HABRILAN","easyfairsiberia",1,0,0,1,2021-11-15
"HABRILAN","Equiplast",1,0,0,1,2021-11-15
"HABRILAN","EsAirbus",1,0,0,1,2021-11-15
"HABRILAN","esplasticos",1,0,0,1,2021-11-15
"HABRILAN","Eurosurfas",1,0,0,1,2021-11-15
"HABRILAN","expoquimia",1,0,0,1,2021-11-15
"HABRILAN","Feria_Valencia",1,0,0,1,2021-11-15
"HABRILAN","feriaecofira",1,0,0,1,2021-11-15
"HABRILAN","Fira_Barcelona",1,0,0,1,2021-11-15
"HABRILAN","GVAivace",1,0,0,1,2021-11-15
"HABRILAN","IFEMA",1,0,0,1,2021-11-15
"HABRILAN","MetalMadridEs",1,0,0,1,2021-11-15
"HABRILAN","MtorresRsc",1,0,0,1,2021-11-15
"HABRILAN","TalgoGroup",1,0,0,1,2021-11-15
"HABRILAN","tecnalia",1,0,0,1,2021-11-15
"HABRILAN","UdGPolitecnica",1,0,0,1,2021-11-15
"hasta_el_lunes","canalsur",1,0,0,1,2021-11-15
"hasta_el_lunes","canalsurcordoba",1,0,0,1,2021-11-15
"hasta_el_lunes","ensgismau",1,0,0,1,2021-11-15
"hasta_el_lunes","hasta_el_lunes",0,0,1,1,2021-11-15
"hasta_el_lunes","manavas21",1,0,0,1,2021-11-15
"hasta_el_lunes","vir_montero",1,0,0,1,2021-11-15
"heroes_urbanos","aimplas",1,0,0,1,2021-11-15
"heroes_urbanos","CORDIS_EU",1,0,0,1,2021-11-15
"heroes_urbanos","URBANREC_H2020",1,0,0,1,2021-11-15
"HGUVALENCIA","aimplas",1,0,0,1,2021-11-15
"HGUVALENCIA","HGUVALENCIA",1,0,0,1,2021-11-15
"HGUVALENCIA","ibv_org",1,0,0,1,2021-11-15
"HGUVALENCIA","IRTIC_UV",1,0,0,1,2021-11-15
"Hispackbcn","Cicloplast_com",1,0,0,1,2021-11-15
"Hispackbcn","esplasticos",1,0,0,1,2021-11-15
"Hispackbcn","Hispackbcn",1,0,0,1,2021-11-15
"Hispacoop","aimplas",1,0,0,1,2021-11-15
"HorizonBooster","aimplas",1,0,0,1,2021-11-15
"HorizonBooster","RECOTRANS_H2020",1,0,0,1,2021-11-15
"Horticom","aimplas",1,0,0,1,2021-11-15
"HospitalLaFe","aimplas",1,0,0,1,2021-11-15
"HospitalLaFe","Betelgeux_es",1,0,0,1,2021-11-15
"HospitalLaFe","GVAavi",1,0,0,1,2021-11-15
"HospitalLaFe","HospitalLaFe",1,0,0,1,2021-11-15
"HospitalLaFe","IISLaFe",1,0,0,1,2021-11-15
"HospitalLaFe","ITQ_UPVCSIC",1,0,0,1,2021-11-15
"HospitalLaFe","UPV",1,0,0,1,2021-11-15
"i_alimentacion","ainiatecnologia",1,0,0,1,2021-11-15
"i_cardenal","aimplas",1,0,0,1,2021-11-15
"i_cardenal","i_cardenal",0,0,1,1,2021-11-15
"iambiente","itenergia",1,0,0,1,2021-11-15
"IBIAE","IESLaFoiaIbi",1,0,0,1,2021-11-15
"ibv_org","3DPrinting_Des",1,0,0,1,2021-11-15
"ibv_org","AutPortValencia",1,0,0,1,2021-11-15
"ibv_org","elperiodic",1,0,0,1,2021-11-15
"ibv_org","floridauni",1,0,0,1,2021-11-15
"ibv_org","GeriatricArea",1,0,0,1,2021-11-15
"ibv_org","IMMedicoHosp",1,0,0,1,2021-11-15
"ibv_org","Institutoai2upv",1,0,0,1,2021-11-15
"ibv_org","int_impresion3D",1,0,0,1,2021-11-15
"ibv_org","LaVanguardia",1,0,0,1,2021-11-15
"ibv_org","prevencionar",1,0,0,1,2021-11-15
"ibv_org","UV_EG",1,0,0,1,2021-11-15
"idainature","aimplas",1,0,0,1,2021-11-15
"IDEKO_","AEMAC_",1,0,0,1,2021-11-15
"IDEKO_","aernnova_usa",1,0,0,1,2021-11-15
"IDEKO_","aeroespacialUPM",1,0,0,1,2021-11-15
"IDEKO_","aimplas",1,0,0,1,2021-11-15
"IDEKO_","AirbusHeli",1,0,0,1,2021-11-15
"IDEKO_","amade_udg",1,0,0,1,2021-11-15
"IDEKO_","DanobatSheetMet",1,0,0,1,2021-11-15
"IDEKO_","HexcelCorp",1,0,0,1,2021-11-15
"IDEKO_","IDEKO_",1,0,0,1,2021-11-15
"IDEKO_","TalgoGroup",1,0,0,1,2021-11-15
"IDEKO_","tsisl_oficial",1,0,0,1,2021-11-15
"IDiBE_UMH","aimplas",1,0,0,1,2021-11-15
"IfapaOlivar","aimplas",1,0,0,1,2021-11-15
"IfapaOlivar","mercacei",0,1,0,1,2021-11-15
"IFATworldwide","aimplas",1,0,0,1,2021-11-15
"IFATworldwide","DafiaProject",1,0,0,1,2021-11-15
"IMDEA_Agua","aimplas",1,0,0,1,2021-11-15
"IMDEA_Agua","IMDEA_Agua",1,0,0,1,2021-11-15
"impulsa_ciu","aimplas",1,0,0,1,2021-11-15
"inam_uji","aimplas",1,0,0,1,2021-11-15
"IndustrialesCV","aimplas",1,0,0,1,2021-11-15
"IndustrialesCV","UPV",1,0,0,1,2021-11-15
"Industrias_TAYG","aimplas",1,0,0,1,2021-11-15
"Industrias_TAYG","Mundoplast",1,0,0,1,2021-11-15
"industry_arena","accio_cat",1,0,0,1,2021-11-15
"industry_arena","AMETIC_es",1,0,0,1,2021-11-15
"industry_arena","ascameorg",1,0,0,1,2021-11-15
"industry_arena","asegre01",1,0,0,1,2021-11-15
"industry_arena","camarascomercio",1,0,0,1,2021-11-15
"industry_arena","cambrabcn",1,0,0,1,2021-11-15
"industry_arena","eoi",1,0,0,1,2021-11-15
"industry_arena","Eurecat",1,0,0,1,2021-11-15
"industry_arena","FIDAMC_",1,0,0,1,2021-11-15
"industry_arena","industrialesand",1,0,0,1,2021-11-15
"industry_arena","industry_arena",0,0,1,1,2021-11-15
"industry_arena","InnovALuy",1,0,0,1,2021-11-15
"industry_arena","mincoturgob",1,0,0,1,2021-11-15
"industry_arena","packcluster",1,0,0,1,2021-11-15
"industry_arena","PatronalCecot",1,0,0,1,2021-11-15
"industry_arena","PT3NEO",1,0,0,1,2021-11-15
"IndustryTalksES","Actecosl",1,0,0,1,2021-11-15
"IndustryTalksES","Agenda2030Gob",1,0,0,1,2021-11-15
"IndustryTalksES","airesaslu",1,0,0,1,2021-11-15
"IndustryTalksES","BlueplasmaPower",1,0,0,1,2021-11-15
"IndustryTalksES","SustainableInnE",1,0,0,1,2021-11-15
"InescopTech","AIDIMME",1,0,0,1,2021-11-15
"InescopTech","aimplas",1,0,0,1,2021-11-15
"InescopTech","alicanteplaza",1,0,0,1,2021-11-15
"InescopTech","maytedomingo_",0,1,0,1,2021-11-15
"InescopTech","valenciaplaza",1,0,0,1,2021-11-15
"infoagrocom","Cicloplast",1,0,0,1,2021-11-15
"infoagrocom","UV_EG",1,0,0,1,2021-11-15
"informaciontvA","aimplas",1,0,0,1,2021-11-15
"informaciontvA","GVAavi",1,0,0,1,2021-11-15
"informaciontvA","ITC_Packaging",1,0,0,1,2021-11-15
"informaciontvA","nandorico16",1,0,0,1,2021-11-15
"informaciontvA","UA_Universidad",1,0,0,1,2021-11-15
"informaciontvA","UA_Universitat",1,0,0,1,2021-11-15
"innotransfer","MosaikUrbanSys",1,0,0,1,2021-11-15
"innotransfer","SchneiderES",1,0,0,1,2021-11-15
"innotransfer","SGS_Spain",1,0,0,1,2021-11-15
"innotransfer","UJIuniversitat",1,0,0,1,2021-11-15
"InnowayST","aimplas",1,0,0,1,2021-11-15
"InnowayST","Cicloplast_com",1,0,0,1,2021-11-15
"InnowayST","industriambient",1,0,0,1,2021-11-15
"int_textil","aimplas",1,0,0,1,2021-11-15
"iolunadeJupiter","aimplas",1,0,0,1,2021-11-15
"iolunadeJupiter","Betelgeux_es",1,0,0,1,2021-11-15
"iolunadeJupiter","GVAavi",1,0,0,1,2021-11-15
"iolunadeJupiter","ITQ_UPVCSIC",1,0,0,1,2021-11-15
"IPPTalk","aimplas",1,0,0,1,2021-11-15
"IreneLarroy","accio_cat",1,0,0,1,2021-11-15
"IreneLarroy","aimplas",1,0,0,1,2021-11-15
"IreneLarroy","biocat_cat",1,0,0,1,2021-11-15
"IreneLarroy","CDTIoficial",1,0,0,1,2021-11-15
"IreneLarroy","eencat",1,0,0,1,2021-11-15
"IreneLarroy","Eurecat_news",1,0,0,1,2021-11-15
"IreneLarroy","H2020_Partner",1,0,0,1,2021-11-15
"IreneLarroy","horizonexperts",1,0,0,1,2021-11-15
"IreneLarroy","itene",1,0,0,1,2021-11-15
"IreneLarroy","JCGarcia_CDTI",1,0,0,1,2021-11-15
"IreneLarroy","jordipietx",1,0,0,1,2021-11-15
"IreneLarroy","marcsattacks",1,0,0,1,2021-11-15
"IreneLarroy","RosaAriasAlv",1,0,0,1,2021-11-15
"IreneLarroy","scibus",1,0,0,1,2021-11-15
"IreneLarroy","SorosGabinete",1,0,0,1,2021-11-15
"IreneLarroy","talk2much12",1,0,0,1,2021-11-15
"IreneLarroy","Wendy_Moreno_EU",1,0,0,1,2021-11-15
"iResiduo","ANARPLA",1,0,0,1,2021-11-15
"iResiduo","AvepAsociacion",1,0,0,1,2021-11-15
"iResiduo","Cicloplast_com",1,0,0,1,2021-11-15
"iResiduo","PlasticsEuropES",1,0,0,1,2021-11-15
"istobal_es","aimplas",1,0,0,1,2021-11-15
"istobal_es","BancoSabadell",1,0,0,1,2021-11-15
"istobal_es","Grupo_Soledad",1,0,0,1,2021-11-15
"istobal_es","levante_emv",1,0,0,1,2021-11-15
"istobal_es","sabadellprensa",0,1,0,1,2021-11-15
"ISWA_org","CTAG_Materials",1,0,0,1,2021-11-15
"ISWA_org","Daimler",1,0,0,1,2021-11-15
"ISWA_org","panasonic",1,0,0,1,2021-11-15
"ISWA_org","panasonic_lstr",1,0,0,1,2021-11-15
"ITACYL","Fundacion_CTME",1,0,0,1,2021-11-15
"ITACYL","inbiotecenlared",1,0,0,1,2021-11-15
"ITACYL","Vitartis",1,0,0,1,2021-11-15
"ITC_ceramica","AgEInves",1,0,0,1,2021-11-15
"ITC_ceramica","asociacionruvid",1,0,0,1,2021-11-15
"ITC_ceramica","CLAMDesarrollo",1,0,0,1,2021-11-15
"ITC_ceramica","copecastellon",0,1,0,1,2021-11-15
"ITC_ceramica","CSICval",1,0,0,1,2021-11-15
"ITC_ceramica","exagres",1,0,0,1,2021-11-15
"ITC_ceramica","FConexus",1,0,0,1,2021-11-15
"ITC_ceramica","Fedit",1,0,0,1,2021-11-15
"ITC_ceramica","Fritta_slu",1,0,0,1,2021-11-15
"ITC_ceramica","GVAddigital",1,0,0,1,2021-11-15
"ITC_ceramica","GVAinnova",1,0,0,1,2021-11-15
"ITC_ceramica","KerabenGrupo",1,0,0,1,2021-11-15
"ITC_ceramica","ReciclaliaC",1,0,0,1,2021-11-15
"ITC_ceramica","seimedcv",1,0,0,1,2021-11-15
"ITC_ceramica","SiemensGamesaES",1,0,0,1,2021-11-15
"ITC_ceramica","sofitec_",1,0,0,1,2021-11-15
"ITC_ceramica","Startup_VLC",1,0,0,1,2021-11-15
"ITC_ceramica","UJIuniversitat",1,0,0,1,2021-11-15
"ITC_ceramica","universitat",1,0,0,1,2021-11-15
"itenergia","igcamag",1,0,0,1,2021-11-15
"itenergia","jaceral",1,0,0,1,2021-11-15
"itenergia","jmasbelso",1,0,0,1,2021-11-15
"itenergia","nexusintegra",1,0,0,1,2021-11-15
"ITI_TIC","AdelaRuizD",1,0,0,1,2021-11-15
"ITI_TIC","ivace",1,0,0,1,2021-11-15
"ITQ_UPVCSIC","Betelgeux_es",1,0,0,1,2021-11-15
"ITQ_UPVCSIC","CSIC",1,0,0,1,2021-11-15
"ITQ_UPVCSIC","CSICval",1,0,0,1,2021-11-15
"ITQ_UPVCSIC","HospitalLaFe",1,0,0,1,2021-11-15
"ITQ_UPVCSIC","Industrias_TAYG",1,0,0,1,2021-11-15
"ITQ_UPVCSIC","itmupv",1,0,0,1,2021-11-15
"ivanalbertos81","aimplas",1,0,0,1,2021-11-15
"ivanalbertos81","BASF_ES",1,0,0,1,2021-11-15
"ivanalbertos81","Petstarmx",1,0,0,1,2021-11-15
"ivanalbertos81","Recuwaste",1,0,0,1,2021-11-15
"izarotech","ainiatecnologia",1,0,0,1,2021-11-15
"izarotech","AvepAsociacion",1,0,0,1,2021-11-15
"izarotech","CIDETEC_",1,0,0,1,2021-11-15
"izarotech","InescopTech",1,0,0,1,2021-11-15
"izarotech","Nestle_es",1,0,0,1,2021-11-15
"izarotech","PlasticsEurope",1,0,0,1,2021-11-15
"izarotech","tecnalia",1,0,0,1,2021-11-15
"izarotech","TeknikerOficial",1,0,0,1,2021-11-15
"IzasaScientific","jcst2801",1,0,0,1,2021-11-15
"jadfrias","aimplas",1,0,0,1,2021-11-15
"jadfrias","BASF_ES",1,0,0,1,2021-11-15
"jadfrias","Repsol",1,0,0,1,2021-11-15
"jadfrias","SABIC",1,0,0,1,2021-11-15
"javiergarciamar","AIDIMME",1,0,0,1,2021-11-15
"javiergarciamar","AIJU_Tecnologi",1,0,0,1,2021-11-15
"javiergarciamar","aimplas",1,0,0,1,2021-11-15
"javiergarciamar","ainiatecnologia",1,0,0,1,2021-11-15
"javiergarciamar","aitex_es",1,0,0,1,2021-11-15
"javiergarciamar","Fedit",1,0,0,1,2021-11-15
"javiergarciamar","InescopTech",1,0,0,1,2021-11-15
"javiergarciamar","ITC_ceramica",1,0,0,1,2021-11-15
"javiergarciamar","itenergia",1,0,0,1,2021-11-15
"javiergarciamar","Redit_es",1,0,0,1,2021-11-15
"jealvarez","ACortinaPantion",1,0,0,1,2021-11-15
"jealvarez","Correos",1,0,0,1,2021-11-15
"jealvarez","cristinasancho",1,0,0,1,2021-11-15
"jealvarez","EspejoPublico",1,0,0,1,2021-11-15
"jealvarez","foroinserta",1,0,0,1,2021-11-15
"jealvarez","IKEASpain",1,0,0,1,2021-11-15
"JECComposites","TeknikerOficial",1,0,0,1,2021-11-15
"JECComposites","TNO_Research",1,0,0,1,2021-11-15
"jesus_calvo","aimplas",1,0,0,1,2021-11-15
"joanros78","AvepAsociacion",1,0,0,1,2021-11-15
"joanros78","GVAinnova",1,0,0,1,2021-11-15
"JorgeGdeOpazo","aimplas",1,0,0,1,2021-11-15
"JorgeGdeOpazo","CdeCarnica",1,0,0,1,2021-11-15
"joveryolanda","aimplas",1,0,0,1,2021-11-15
"joveryolanda","coneselisa",1,0,0,1,2021-11-15
"joveryolanda","Oceanografic_vl",1,0,0,1,2021-11-15
"joveryolanda","placadelllibre",1,0,0,1,2021-11-15
"jp_torregrosa","aimplas",1,0,0,1,2021-11-15
"jp_torregrosa","BIOVAL_es",1,0,0,1,2021-11-15
"jp_torregrosa","itenergia",1,0,0,1,2021-11-15
"juliabrines","aimplas",1,0,0,1,2021-11-15
"juliabrines","expansioncom",1,0,0,1,2021-11-15
"juliatomas3","aimplas",1,0,0,1,2021-11-15
"KerabenGrupo","aimplas",1,0,0,1,2021-11-15
"khaqanshati","aimplas",1,0,0,1,2021-11-15
"khaqanshati","CalipsoPlus",1,0,0,1,2021-11-15
"khaqanshati","cepyme_",1,0,0,1,2021-11-15
"khaqanshati","confemetal",1,0,0,1,2021-11-15
"khaqanshati","Feique_ES",1,0,0,1,2021-11-15
"KimitecGroup","CDTIoficial",1,0,0,1,2021-11-15
"KimitecGroup","CienciaGob",1,0,0,1,2021-11-15
"KimitecGroup","InfoUMA",1,0,0,1,2021-11-15
"KimitecGroup","ualmeria",1,0,0,1,2021-11-15
"KimitecGroup","UPV",1,0,0,1,2021-11-15
"LAB_Ecoinnova","Actecosl",1,0,0,1,2021-11-15
"LAB_Ecoinnova","aimplas",1,0,0,1,2021-11-15
"LAB_Ecoinnova","BioICEP_IMGGE",1,0,0,1,2021-11-15
"LAB_Ecoinnova","RevistaRETEMA",1,0,0,1,2021-11-15
"LaboralLab_","aimplas",1,0,0,1,2021-11-15
"LaboralLab_","antena3com",1,0,0,1,2021-11-15
"LaboralLab_","AsocEyC",1,0,0,1,2021-11-15
"LaboralLab_","Correos",1,0,0,1,2021-11-15
"LaboralLab_","EspejoPublico",1,0,0,1,2021-11-15
"LaboralLab_","foroinserta",1,0,0,1,2021-11-15
"LaboralLab_","Fundacion_ONCE",1,0,0,1,2021-11-15
"lacarolinajaen","aimplas",1,0,0,1,2021-11-15
"lacarolinajaen","CentrosCex",1,0,0,1,2021-11-15
"lacarolinajaen","escamilla50",1,0,0,1,2021-11-15
"lacarolinajaen","generalitat",1,0,0,1,2021-11-15
"lacarolinajaen","GVAivace",1,0,0,1,2021-11-15
"lacarolinajaen","Julia_company",1,0,0,1,2021-11-15
"lacarolinajaen","Rafa_Climentg",1,0,0,1,2021-11-15
"LanzaTech","aimplas",1,0,0,1,2021-11-15
"LaPalestraJca","aimplas",1,0,0,1,2021-11-15
"LaPalestraJca","MatiesAmparo",1,0,0,1,2021-11-15
"LasNaves","aimplas",1,0,0,1,2021-11-15
"LasNaves","AjuntamentVLC",1,0,0,1,2021-11-15
"LasNaves","carlosgaliana",1,0,0,1,2021-11-15
"LasNaves","martachillaron",1,0,0,1,2021-11-15
"LifeEpsSure","4filmLife",1,0,0,1,2021-11-15
"LifeEpsSure","ANAIP_es",1,0,0,1,2021-11-15
"LifeEpsSure","andaltec",1,0,0,1,2021-11-15
"LifeEpsSure","lifeplasmix",1,0,0,1,2021-11-15
"LifeEpsSure","ResiduosPro",1,0,0,1,2021-11-15
"lilifondevila","aimplas",1,0,0,1,2021-11-15
"LinkenerSpain","angelramire",1,0,0,1,2021-11-15
"LinkenerSpain","EosOrbital",1,0,0,1,2021-11-15
"LinkenerSpain","GlobalOmnium",1,0,0,1,2021-11-15
"LinkenerSpain","GoHubTech",1,0,0,1,2021-11-15
"LinkenerSpain","JuanPeaIbaez2",1,0,0,1,2021-11-15
"LinkenerSpain","LinkenerSpain",1,0,0,1,2021-11-15
"LinkenerSpain","pepesiega",1,0,0,1,2021-11-15
"LISSolutionsTW","iVale7",1,0,0,1,2021-11-15
"LolaFPaniagua","ainiatecnologia",1,0,0,1,2021-11-15
"LolaFPaniagua","ANAIP_es",1,0,0,1,2021-11-15
"LolaFPaniagua","ANARPLA",1,0,0,1,2021-11-15
"LolaFPaniagua","danone_es",1,0,0,1,2021-11-15
"LolaFPaniagua","faerchgroup",1,0,0,1,2021-11-15
"LolaFPaniagua","Nestle_es",1,0,0,1,2021-11-15
"LolaFPaniagua","UV_EG",1,0,0,1,2021-11-15
"londones","aimplas",1,0,0,1,2021-11-15
"londones","corifyAF",1,0,0,1,2021-11-15
"londones","Grupo_TSK",1,0,0,1,2021-11-15
"londones","Molecor",1,0,0,1,2021-11-15
"londones","PigCHAMP_Europa",1,0,0,1,2021-11-15
"londones","skrollerbelt",1,0,0,1,2021-11-15
"LosPackaging","ainiatecnologia",1,0,0,1,2021-11-15
"LosPackaging","CdeCarnica",1,0,0,1,2021-11-15
"Luis_RoFe","AceiteOlivalle",1,0,0,1,2021-11-15
"Luis_RoFe","aimplas",1,0,0,1,2021-11-15
"luispatinoangel","aimplas",1,0,0,1,2021-11-15
"luispatinoangel","luispatinoangel",1,0,0,1,2021-11-15
"mafehegu","Cicloplast_com",1,0,0,1,2021-11-15
"manccampdeturia","aimplas",1,0,0,1,2021-11-15
"manccampdeturia","ajtlapobla",1,0,0,1,2021-11-15
"manccampdeturia","AjuntamentSerra",1,0,0,1,2021-11-15
"manccampdeturia","ajvilamarxant",1,0,0,1,2021-11-15
"manccampdeturia","ayto_riba_roja",1,0,0,1,2021-11-15
"manccampdeturia","AytoBenaguasil",1,0,0,1,2021-11-15
"manccampdeturia","Aytobetera",1,0,0,1,2021-11-15
"manccampdeturia","aytolliria",1,0,0,1,2021-11-15
"manccampdeturia","AytoLoriguilla",1,0,0,1,2021-11-15
"manccampdeturia","AytoMarines",1,0,0,1,2021-11-15
"manccampdeturia","AytoNaquera",1,0,0,1,2021-11-15
"manccampdeturia","AyuntamientoSAB",1,0,0,1,2021-11-15
"manccampdeturia","benissano",1,0,0,1,2021-11-15
"manccampdeturia","GVAlabora",1,0,0,1,2021-11-15
"MariaBellmunt","abionica_UAS",1,0,0,1,2021-11-15
"MariaBellmunt","aimplas",1,0,0,1,2021-11-15
"MariaBellmunt","brokair",1,0,0,1,2021-11-15
"MariaBellmunt","CDTIoficial",1,0,0,1,2021-11-15
"MariaBellmunt","Defensagob",1,0,0,1,2021-11-15
"MariaBellmunt","FGlobalis",0,1,0,1,2021-11-15
"MariaBellmunt","infoGMV_es",1,0,0,1,2021-11-15
"MariaBellmunt","PLD_Space",1,0,0,1,2021-11-15
"MaripeSamper","CentrosCex",1,0,0,1,2021-11-15
"MaripeSamper","escamilla50",1,0,0,1,2021-11-15
"MaripeSamper","generalitat",1,0,0,1,2021-11-15
"MaripeSamper","GVAivace",1,0,0,1,2021-11-15
"MaripeSamper","Julia_company",1,0,0,1,2021-11-15
"MaripeSamper","Rafa_Climentg",1,0,0,1,2021-11-15
"MartaEGMosquera","AytoAlcalaH",1,0,0,1,2021-11-15
"MartaEGMosquera","CBachiller",1,0,0,1,2021-11-15
"MartaEGMosquera","lucilu_o13",1,0,0,1,2021-11-15
"MartaEGMosquera","MDPIOpenAccess",1,0,0,1,2021-11-15
"MartaEGMosquera","mWeek_Alcala",1,0,0,1,2021-11-15
"MartaEGMosquera","mWeek_MWC",1,0,0,1,2021-11-15
"martarojo_","aimplas",1,0,0,1,2021-11-15
"martarojo_","itenergia",1,0,0,1,2021-11-15
"Mateprincs","3Neo",1,0,0,1,2021-11-15
"Mateprincs","Cluster",1,0,0,1,2021-11-15
"Mateprincs","ep",1,0,0,1,2021-11-15
"Mateprincs","naitec",1,0,0,1,2021-11-15
"Mateprincs","swansea",1,0,0,1,2021-11-15
"Mateprincs","SwanseaUni",1,0,0,1,2021-11-15
"materplat","Adif_es",1,0,0,1,2021-11-15
"materplat","AgEInves",1,0,0,1,2021-11-15
"materplat","CIDETEC",1,0,0,1,2021-11-15
"materplat","CIDETEC_",1,0,0,1,2021-11-15
"materplat","CienciaGob",1,0,0,1,2021-11-15
"materplat","CTAG_Materials",1,0,0,1,2021-11-15
"materplat","mitmagob",1,0,0,1,2021-11-15
"materplat","Shift2Rail_JU",1,0,0,1,2021-11-15
"materplat","TalgoGroup",1,0,0,1,2021-11-15
"materplat","tecnalia",1,0,0,1,2021-11-15
"maytedomingo_","AIJU_Tecnologi",1,0,0,1,2021-11-15
"maytedomingo_","aitex_es",1,0,0,1,2021-11-15
"maytedomingo_","Faurecia",1,0,0,1,2021-11-15
"maytedomingo_","garcia_saludes",1,0,0,1,2021-11-15
"maytedomingo_","GreenTurf",1,0,0,1,2021-11-15
"maytedomingo_","iberapa",1,0,0,1,2021-11-15
"maytedomingo_","InescopTech",1,0,0,1,2021-11-15
"maytedomingo_","Julia_company",1,0,0,1,2021-11-15
"maytedomingo_","Porcelanosa_es",1,0,0,1,2021-11-15
"maytedomingo_","realturfoficial",1,0,0,1,2021-11-15
"maytedomingo_","Saludes_Ind",1,0,0,1,2021-11-15
"MediterraneoPre","aimplas",1,0,0,1,2021-11-15
"MediterraneoPre","GlobalOmnium",1,0,0,1,2021-11-15
"MediterraneoPre","GVAavi",1,0,0,1,2021-11-15
"MediterraneoPre","GVAinnova",1,0,0,1,2021-11-15
"MediterraneoPre","UVa_es",1,0,0,1,2021-11-15
"mercacei","aimplas",1,0,0,1,2021-11-15
"micijor","aimplas",1,0,0,1,2021-11-15
"micijor","coneselisa",1,0,0,1,2021-11-15
"micijor","Oceanografic_vl",1,0,0,1,2021-11-15
"micijor","placadelllibre",1,0,0,1,2021-11-15
"MinarroFin","aimplas",1,0,0,1,2021-11-15
"MinarroFin","VicenteAbella",1,0,0,1,2021-11-15
"MincienciasCo","aimplas",1,0,0,1,2021-11-15
"MincienciasCo","MincienciasCo",0,0,1,1,2021-11-15
"MincienciasCo","TitoCrissien",1,0,0,1,2021-11-15
"miyoresponsable","aimplas",1,0,0,1,2021-11-15
"MobilityVlc","AgfraSL",1,0,0,1,2021-11-15
"MobilityVlc","ibv_org",1,0,0,1,2021-11-15
"MobilityVlc","ITI_TIC",1,0,0,1,2021-11-15
"MobilityVlc","SGS_SA",1,0,0,1,2021-11-15
"Monviciano","AndreaFontanaEU",1,0,0,1,2021-11-15
"Monviciano","Dr_alshreka",1,0,0,1,2021-11-15
"Monviciano","EU_Commission",1,0,0,1,2021-11-15
"Monviciano","EU_FPI",1,0,0,1,2021-11-15
"Monviciano","EUgreenresearch",1,0,0,1,2021-11-15
"Monviciano","expo2020dubai",1,0,0,1,2021-11-15
"Monviciano","expo2020se",1,0,0,1,2021-11-15
"Monviciano","GCCSG",1,0,0,1,2021-11-15
"Monviciano","MICleanEnergyRD",1,0,0,1,2021-11-15
"MPN_Magazine","LeistritzCorp",1,0,0,1,2021-11-15
"mrtmi3g","aimplas",1,0,0,1,2021-11-15
"mtmachado","RevistaRETEMA",1,0,0,1,2021-11-15
"mtmachado","UV_EG",1,0,0,1,2021-11-15
"Mundoplast","aitiip",1,0,0,1,2021-11-15
"Mundoplast","AvepAsociacion",1,0,0,1,2021-11-15
"Mundoplast","CIDETEC_",1,0,0,1,2021-11-15
"Mundoplast","esplasticos",1,0,0,1,2021-11-15
"Mundoplast","GVAivace",1,0,0,1,2021-11-15
"Mundoplast","PlasticsEuropES",1,0,0,1,2021-11-15
"Mundoplast","raorsamaq",1,0,0,1,2021-11-15
"Mundoplast","UPV",1,0,0,1,2021-11-15
"Mundoplast","UV_EG",1,0,0,1,2021-11-15
"NanomedicineLab","aimplas",1,0,0,1,2021-11-15
"NanomedicineLab","CEA_Officiel",1,0,0,1,2021-11-15
"NanomedicineLab","DTUtweet",1,0,0,1,2021-11-15
"NanomedicineLab","EU_H2020",1,0,0,1,2021-11-15
"NanomedicineLab","FBMH_UoM",1,0,0,1,2021-11-15
"NanomedicineLab","FFIS_CARM",1,0,0,1,2021-11-15
"NanomedicineLab","FIOH",1,0,0,1,2021-11-15
"NanomedicineLab","Inserm_EN",1,0,0,1,2021-11-15
"NanomedicineLab","OfficialUoM",1,0,0,1,2021-11-15
"NanomedicineLab","ScienceMagazine",0,1,0,1,2021-11-15
"NanomedicineLab","UABBarcelona",1,0,0,1,2021-11-15
"NanomedicineLab","UFZ_de",1,0,0,1,2021-11-15
"NanomedicineLab","UniLeipzig",1,0,0,1,2021-11-15
"NanomedicineLab","WUR",1,0,0,1,2021-11-15
"NanomedSpain","aimplas",1,0,0,1,2021-11-15
"NanomedSpain","ClusterFPrint",1,0,0,1,2021-11-15
"NanomedSpain","fenin_es",1,0,0,1,2021-11-15
"NanomedSpain","NanomedSpain",1,0,0,1,2021-11-15
"NanomedSpain","PT3NEO",1,0,0,1,2021-11-15
"nemosineproject","aimplas",1,0,0,1,2021-11-15
"nemosineproject","nemosineproject",1,0,0,1,2021-11-15
"NormasUNE","aimplas",1,0,0,1,2021-11-15
"NormasUNE","ANAIP_es",1,0,0,1,2021-11-15
"Novamont_Iberia","expoquimia",1,0,0,1,2021-11-15
"Novamont_Iberia","materbi",1,0,0,1,2021-11-15
"nuevoagrodiario","aimplas",1,0,0,1,2021-11-15
"nuevoagrodiario","ainiatecnologia",1,0,0,1,2021-11-15
"Obrasurbanas","aimplas",1,0,0,1,2021-11-15
"OceanetsProject","cinea_eu",0,1,0,1,2021-11-15
"OceanetsProject","easme",1,0,0,1,2021-11-15
"OceanetsProject","GEN_Uvigo",1,0,0,1,2021-11-15
"OceanetsProject","marGnetproject",1,0,0,1,2021-11-15
"OceanetsProject","NetTagProject",1,0,0,1,2021-11-15
"OceanetsProject","rtve",1,0,0,1,2021-11-15
"OceanetsProject","vincenzo_gente",1,0,0,1,2021-11-15
"Oceanografic_vl","aimplas",1,0,0,1,2021-11-15
"Oceanografic_vl","CruzRojaEsp",1,0,0,1,2021-11-15
"OCRValencia","AIDIMME",1,0,0,1,2021-11-15
"OCRValencia","ainiatecnologia",1,0,0,1,2021-11-15
"OCRValencia","AjuntamentVLC",1,0,0,1,2021-11-15
"OCRValencia","AMITMu_Val",1,0,0,1,2021-11-15
"OCRValencia","amperexenergy",1,0,0,1,2021-11-15
"OCRValencia","AVAESEN",1,0,0,1,2021-11-15
"OCRValencia","Bego_Pe",1,0,0,1,2021-11-15
"OCRValencia","caixapopular",1,0,0,1,2021-11-15
"OCRValencia","carlosgaliana",1,0,0,1,2021-11-15
"OCRValencia","eduard_urena",1,0,0,1,2021-11-15
"OCRValencia","GVAivace",1,0,0,1,2021-11-15
"OCRValencia","ibv_org",1,0,0,1,2021-11-15
"OCRValencia","InescopTech",1,0,0,1,2021-11-15
"OCRValencia","ITC_ceramica",1,0,0,1,2021-11-15
"OCRValencia","itene",1,0,0,1,2021-11-15
"OCRValencia","itenergia",1,0,0,1,2021-11-15
"OCRValencia","ITI_TIC",1,0,0,1,2021-11-15
"OCRValencia","JMendigacha",1,0,0,1,2021-11-15
"OCRValencia","LafargeHolcimES",1,0,0,1,2021-11-15
"OCRValencia","laprimerapiedra",1,0,0,1,2021-11-15
"OCRValencia","malbors",1,0,0,1,2021-11-15
"OCRValencia","OndaCero_es",1,0,0,1,2021-11-15
"OCRValencia","socialnest_org",1,0,0,1,2021-11-15
"OCRValencia","veintiuno_music",1,0,0,1,2021-11-15
"OEPM_es","protermosolar",1,0,0,1,2021-11-15
"OEPM_es","pteco2",1,0,0,1,2021-11-15
"OEPM_es","solarconcentra",1,0,0,1,2021-11-15
"OleoRevista","ainiatecnologia",1,0,0,1,2021-11-15
"OleoRevista","GVAivace",1,0,0,1,2021-11-15
"olgainfoedita","infoconstru",0,1,0,1,2021-11-15
"olgainfoedita","tecnoalimen",0,1,0,1,2021-11-15
"omenendez","aimplas",1,0,0,1,2021-11-15
"omenendez","Airbus",1,0,0,1,2021-11-15
"omenendez","BASF_ES",1,0,0,1,2021-11-15
"omenendez","Cefic",1,0,0,1,2021-11-15
"omenendez","deborahciencia",1,0,0,1,2021-11-15
"omenendez","foretica",1,0,0,1,2021-11-15
"omenendez","Pascual",1,0,0,1,2021-11-15
"omenendez","PlasticsEuropES",1,0,0,1,2021-11-15
"omenendez","Repsol",1,0,0,1,2021-11-15
"omenendez","SABIC",1,0,0,1,2021-11-15
"omenendez","ternua",1,0,0,1,2021-11-15
"ondalocalemartv","aimplas",1,0,0,1,2021-11-15
"ondalocalemartv","CoopsAgroAND",1,0,0,1,2021-11-15
"ondalocalemartv","Oliplast",1,0,0,1,2021-11-15
"opdi_tex_GmbH","aimplas",1,0,0,1,2021-11-15
"opdi_tex_GmbH","BcompLtd",1,0,0,1,2021-11-15
"opdi_tex_GmbH","CompPairTech",1,0,0,1,2021-11-15
"opdi_tex_GmbH","EDAGGroup",1,0,0,1,2021-11-15
"opdi_tex_GmbH","EireComposites",1,0,0,1,2021-11-15
"opdi_tex_GmbH","Fraunhofer_IWU",1,0,0,1,2021-11-15
"opdi_tex_GmbH","FraunhoferIGCV",1,0,0,1,2021-11-15
"opdi_tex_GmbH","MCAMconnect",1,0,0,1,2021-11-15
"opdi_tex_GmbH","NCCUKinfo",1,0,0,1,2021-11-15
"opdi_tex_GmbH","RWTH",1,0,0,1,2021-11-15
"OpenFuture_And","AgriculturAnd",1,0,0,1,2021-11-15
"OpenFuture_And","aimplas",1,0,0,1,2021-11-15
"OpenFuture_And","Bioeconomia_And",1,0,0,1,2021-11-15
"OpenFuture_And","CTAndalucia",1,0,0,1,2021-11-15
"OpenFuture_And","DataAgriS3",1,0,0,1,2021-11-15
"OpenFuture_And","DIHAndAgrotech",1,0,0,1,2021-11-15
"OpenFuture_And","eoi",1,0,0,1,2021-11-15
"OpenFuture_And","Fertinagro",1,0,0,1,2021-11-15
"OpenFuture_And","GrupoCosentino",1,0,0,1,2021-11-15
"OpenFuture_And","IBEROSTAR",1,0,0,1,2021-11-15
"OpenFuture_And","ImpactHubMAD",1,0,0,1,2021-11-15
"ORH_RH","aimplas",1,0,0,1,2021-11-15
"ORH_RH","AsocEyC",1,0,0,1,2021-11-15
"ORH_RH","Correos",1,0,0,1,2021-11-15
"ORH_RH","EspejoPublico",1,0,0,1,2021-11-15
"ORH_RH","foroinserta",1,0,0,1,2021-11-15
"OVTT","ainiatecnologia",1,0,0,1,2021-11-15
"OVTT","ITI_TIC",1,0,0,1,2021-11-15
"OVTT","Packnet_",1,0,0,1,2021-11-15
"OVTTenglish","OEPM_es",1,0,0,1,2021-11-15
"pablo24200","aimplas",1,0,0,1,2021-11-15
"pablo24200","ECOTOX2",1,0,0,1,2021-11-15
"pablo24200","EstrellaDammCat",1,0,0,1,2021-11-15
"pablo24200","EstrellaDammEs",1,0,0,1,2021-11-15
"pablo24200","FBiodiversidad",1,0,0,1,2021-11-15
"pablo24200","FValenciaport",1,0,0,1,2021-11-15
"pablo24200","prendente",1,0,0,1,2021-11-15
"pablo24200","uvigo",1,0,0,1,2021-11-15
"PackagingEurope","PackEuropeEli",1,0,0,1,2021-11-15
"packcluster","3Dnatives_ES",1,0,0,1,2021-11-15
"packcluster","AEBALL_UPMBALL",1,0,0,1,2021-11-15
"packcluster","AEMAC_",1,0,0,1,2021-11-15
"packcluster","AerAutomation",1,0,0,1,2021-11-15
"packcluster","aiasasociacion",1,0,0,1,2021-11-15
"packcluster","aimplas",1,0,0,1,2021-11-15
"packcluster","ascameorg",1,0,0,1,2021-11-15
"packcluster","camarascomercio",1,0,0,1,2021-11-15
"packcluster","cambrabcn",1,0,0,1,2021-11-15
"packcluster","CEPplast",1,0,0,1,2021-11-15
"packcluster","ClusterCICAT",1,0,0,1,2021-11-15
"packcluster","eoi",1,0,0,1,2021-11-15
"packcluster","Eurecat_news",1,0,0,1,2021-11-15
"packcluster","HispaRob",1,0,0,1,2021-11-15
"packcluster","industrialesand",1,0,0,1,2021-11-15
"packcluster","innovallcluster",1,0,0,1,2021-11-15
"packcluster","mincoturgob",1,0,0,1,2021-11-15
"packcluster","PatronalCecot",1,0,0,1,2021-11-15
"packcluster","SECARTYS",1,0,0,1,2021-11-15
"Packnet_","AEMPSGOB",1,0,0,1,2021-11-15
"Packnet_","ANAIP_es",1,0,0,1,2021-11-15
"Packnet_","artsolut",1,0,0,1,2021-11-15
"Packnet_","Decernis",1,0,0,1,2021-11-15
"Packnet_","EMSUR_",1,0,0,1,2021-11-15
"Packnet_","EssentraPackES",1,0,0,1,2021-11-15
"Packnet_","Feique_ES",1,0,0,1,2021-11-15
"Packnet_","Foro_READ",1,0,0,1,2021-11-15
"Packnet_","fpffoundation",1,0,0,1,2021-11-15
"Packnet_","GVAsanitat",1,0,0,1,2021-11-15
"Packnet_","int_envase",0,1,0,1,2021-11-15
"Packnet_","ITC_ceramica",1,0,0,1,2021-11-15
"Packnet_","itene",1,0,0,1,2021-11-15
"Packnet_","LATU_uy",1,0,0,1,2021-11-15
"Packnet_","PKF_ATTEST",1,0,0,1,2021-11-15
"Packnet_","stanpa_es",1,0,0,1,2021-11-15
"Packnet_","UV_EG",1,0,0,1,2021-11-15
"PacoDS","aimplas",1,0,0,1,2021-11-15
"PacoFernandezA2","aimplas",1,0,0,1,2021-11-15
"PacoFernandezA2","geqo_rseq",1,0,0,1,2021-11-15
"PacoFernandezA2","inbiotecenlared",1,0,0,1,2021-11-15
"PacoFernandezA2","IQAR_UAH",1,0,0,1,2021-11-15
"PacoFernandezA2","lualnu10",1,0,0,1,2021-11-15
"PacoFernandezA2","UAHes",1,0,0,1,2021-11-15
"PakoRho","aimplas",1,0,0,1,2021-11-15
"PakoRho","ainiatecnologia",1,0,0,1,2021-11-15
"PakoRho","Arturolarena",1,0,0,1,2021-11-15
"PakoRho","BelenFranch",1,0,0,1,2021-11-15
"PakoRho","cdcampo1",1,0,0,1,2021-11-15
"PakoRho","EFEverde",1,0,0,1,2021-11-15
"PakoRho","FGlobalNature",1,0,0,1,2021-11-15
"PakoRho","trypanus",1,0,0,1,2021-11-15
"parccientificuv","bioferric",1,0,0,1,2021-11-15
"parccientificuv","DarwinBioprosp",1,0,0,1,2021-11-15
"parccientificuv","FacFarmacia_UV",1,0,0,1,2021-11-15
"parccientificuv","GlobalOmnium",1,0,0,1,2021-11-15
"parccientificuv","iata_csic",1,0,0,1,2021-11-15
"parccientificuv","innotransfer",1,0,0,1,2021-11-15
"parccientificuv","UJIuniversitat",1,0,0,1,2021-11-15
"parccientificuv","UPCTnoticias",1,0,0,1,2021-11-15
"Pascual","3duardoFG",1,0,0,1,2021-11-15
"Pascual","abc_es",1,0,0,1,2021-11-15
"Pascual","aimplas",1,0,0,1,2021-11-15
"Pascual","Airbus",1,0,0,1,2021-11-15
"Pascual","BASF_ES",1,0,0,1,2021-11-15
"Pascual","Cefic",1,0,0,1,2021-11-15
"Pascual","charo_barroso",1,0,0,1,2021-11-15
"Pascual","deborahciencia",1,0,0,1,2021-11-15
"Pascual","Equiplast",1,0,0,1,2021-11-15
"Pascual","EsAirbus",1,0,0,1,2021-11-15
"Pascual","esplasticos",1,0,0,1,2021-11-15
"Pascual","Feique_ES",1,0,0,1,2021-11-15
"Pascual","foretica",1,0,0,1,2021-11-15
"Pascual","ForoQyS",1,0,0,1,2021-11-15
"Pascual","omenendez",1,0,0,1,2021-11-15
"Pascual","PlasticsEuropES",1,0,0,1,2021-11-15
"Pascual","Repsol",1,0,0,1,2021-11-15
"Pascual","SABIC",1,0,0,1,2021-11-15
"Pascual","SusChemSpain",1,0,0,1,2021-11-15
"Pascual","ternua",1,0,0,1,2021-11-15
"Pascual","TFundaciones",1,0,0,1,2021-11-15
"PCientificoAlic","AIJU_Tecnologi",1,0,0,1,2021-11-15
"PCientificoAlic","aimplas",1,0,0,1,2021-11-15
"PCientificoAlic","AvepAsociacion",1,0,0,1,2021-11-15
"PCientificoAlic","Erumgroup",1,0,0,1,2021-11-15
"PCientificoAlic","GVAavi",1,0,0,1,2021-11-15
"PCientificoAlic","PCientificoAlic",1,0,0,1,2021-11-15
"PCT_UCN","AIDIMME",1,0,0,1,2021-11-15
"PCT_UCN","AIJU_Tecnologi",1,0,0,1,2021-11-15
"PCT_UCN","aimplas",1,0,0,1,2021-11-15
"PCT_UCN","ainiatecnologia",1,0,0,1,2021-11-15
"PCT_UCN","GVAeconomia",1,0,0,1,2021-11-15
"PCT_UCN","ITC_ceramica",1,0,0,1,2021-11-15
"PCT_UCN","itene",1,0,0,1,2021-11-15
"PCT_UCN","itenergia",1,0,0,1,2021-11-15
"PCT_UCN","Julia_company",1,0,0,1,2021-11-15
"PCT_UCN","Rafa_Climentg",1,0,0,1,2021-11-15
"PCT_UCN","Redit_es",1,0,0,1,2021-11-15
"PCT_UCN","UCNorte",1,0,0,1,2021-11-15
"pedrojcarrillo","Agenda2030Gob",1,0,0,1,2021-11-15
"pedrojcarrillo","aimplas",1,0,0,1,2021-11-15
"pedrojcarrillo","IndustryTalksES",1,0,0,1,2021-11-15
"pedrojcarrillo","SustainableInnE",1,0,0,1,2021-11-15
"PerkinElmer","aimplas",1,0,0,1,2021-11-15
"pharmamarket","ibv_org",1,0,0,1,2021-11-15
"pharmamarket","taygclinic",1,0,0,1,2021-11-15
"pHjools","aimplas",1,0,0,1,2021-11-15
"pHjools","corifyAF",1,0,0,1,2021-11-15
"pHjools","EIT_Health_es",1,0,0,1,2021-11-15
"pHjools","Grupo_TSK",1,0,0,1,2021-11-15
"pHjools","Molecor",1,0,0,1,2021-11-15
"pHjools","PigCHAMP_Europa",1,0,0,1,2021-11-15
"pHjools","PlatinoEduca",1,0,0,1,2021-11-15
"pHjools","skrollerbelt",1,0,0,1,2021-11-15
"pickpackexpo","aimplas",1,0,0,1,2021-11-15
"PilMontana","aimplas",1,0,0,1,2021-11-15
"PilMontana","BASF_ES",1,0,0,1,2021-11-15
"PilMontana","deborahciencia",1,0,0,1,2021-11-15
"PilMontana","Repsol",1,0,0,1,2021-11-15
"PilMontana","SABIC",1,0,0,1,2021-11-15
"PilotHarbour","aivp_net",1,0,0,1,2021-11-15
"PilotHarbour","AjuntamentVLC",1,0,0,1,2021-11-15
"PilotHarbour","AsnavieraVlc",1,0,0,1,2021-11-15
"PilotHarbour","ESPOSecretariat",1,0,0,1,2021-11-15
"PilotHarbour","IMOHQ",1,0,0,1,2021-11-15
"PilotHarbour","propellervlc",1,0,0,1,2021-11-15
"PilotHarbour","PuertosEstado",1,0,0,1,2021-11-15
"Pinfa_EU","aimplas",1,0,0,1,2021-11-15
"plastic_museum","esplasticos",1,0,0,1,2021-11-15
"PlasticFV","GVAivace",1,0,0,1,2021-11-15
"PlasticFV","industriQuimica",1,0,0,1,2021-11-15
"PlasticFV","int_quimica",1,0,0,1,2021-11-15
"PlasticFV","UPV",1,0,0,1,2021-11-15
"PlasticFV","UV_EG",1,0,0,1,2021-11-15
"Plastico_Indl","VTTFinland",1,0,0,1,2021-11-15
"plasticomty","aimplas",1,0,0,1,2021-11-15
"plasticoshita","ANAIP_es",0,1,0,1,2021-11-15
"plasticoshita","ANARPLA",1,0,0,1,2021-11-15
"plasticoshita","AvepAsociacion",1,0,0,1,2021-11-15
"plasticoshita","Cicloplast_com",1,0,0,1,2021-11-15
"plasticoshita","esplasticos",1,0,0,1,2021-11-15
"plasticoshita","plastic_museum",1,0,0,1,2021-11-15
"plasticoshita","PlasticsEurope",1,0,0,1,2021-11-15
"PlasticsEuropES","AceiteOlivalle",1,0,0,1,2021-11-15
"PlasticsEuropES","ainiatecnologia",1,0,0,1,2021-11-15
"PlasticsEuropES","esplasticos",1,0,0,1,2021-11-15
"PlasticsEuropES","plastic_museum",1,0,0,1,2021-11-15
"PlasticsEuropES","shackletongroup",0,1,0,1,2021-11-15
"PlasticsEuropES","SusChemSpain",1,0,0,1,2021-11-15
"PlasticsWorld","Benihort",1,0,0,1,2021-11-15
"PlasticsWorld","RecyclersEU",1,0,0,1,2021-11-15
"PlatinoEduca","aimplas",1,0,0,1,2021-11-15
"PlatinoEduca","corifyAF",1,0,0,1,2021-11-15
"PlatinoEduca","Grupo_TSK",1,0,0,1,2021-11-15
"PlatinoEduca","Molecor",1,0,0,1,2021-11-15
"PlatinoEduca","PigCHAMP_Europa",1,0,0,1,2021-11-15
"PlatinoEduca","skrollerbelt",1,0,0,1,2021-11-15
"plazaradio_","aimplas",1,0,0,1,2021-11-15
"plazaradio_","RafaLupion",1,0,0,1,2021-11-15
"PMLEnergy","aimplas",1,0,0,1,2021-11-15
"PMLEnergy","itenergia",1,0,0,1,2021-11-15
"poscosecha","Benihort",1,0,0,1,2021-11-15
"poscosecha","CSIC",1,0,0,1,2021-11-15
"poscosecha","GVAavi",1,0,0,1,2021-11-15
"poscosecha","IBMCP",1,0,0,1,2021-11-15
"poscosecha","ITC_Packaging",1,0,0,1,2021-11-15
"poscosecha","UPV",1,0,0,1,2021-11-15
"prceinos","aimplas",1,0,0,1,2021-11-15
"prceinos","BIOVAL_es",1,0,0,1,2021-11-15
"prceinos","ceei",1,0,0,1,2021-11-15
"prceinos","ceeivalencia",1,0,0,1,2021-11-15
"prceinos","emprenemjunts",1,0,0,1,2021-11-15
"prceinos","GVAeconomia",1,0,0,1,2021-11-15
"prceinos","itenergia",1,0,0,1,2021-11-15
"PRS_Europe","aimplas",1,0,0,1,2021-11-15
"PT3NEO","aitex_es",1,0,0,1,2021-11-15
"PT3NEO","CienciaGob",1,0,0,1,2021-11-15
"PT3NEO","Eurecat_news",1,0,0,1,2021-11-15
"PT3NEO","fenin_es",1,0,0,1,2021-11-15
"PT3NEO","itene",1,0,0,1,2021-11-15
"PT3NEO","Naitec_CT",1,0,0,1,2021-11-15
"PT3NEO","NanomedSpain",1,0,0,1,2021-11-15
"PT3NEO","PT3NEO",1,0,0,1,2021-11-15
"PT3NEO","tecnalia",1,0,0,1,2021-11-15
"PT3NEO","UNavarra",1,0,0,1,2021-11-15
"PT3NEO","Zabala_IC",1,0,0,1,2021-11-15
"pteco2","funditec",1,0,0,1,2021-11-15
"pteco2","Inerco_",1,0,0,1,2021-11-15
"pteco2","Repsol",1,0,0,1,2021-11-15
"pteco2","SinCeO2",1,0,0,1,2021-11-15
"pteco2","unizar",1,0,0,1,2021-11-15
"QUIMACOVA","aimplas",1,0,0,1,2021-11-15
"QUIMACOVA","camaravalencia",1,0,0,1,2021-11-15
"QUIMACOVA","CDTIoficial",1,0,0,1,2021-11-15
"QUIMACOVA","Cleanity_es",1,0,0,1,2021-11-15
"QUIMACOVA","GVAavi",1,0,0,1,2021-11-15
"QUIMACOVA","GVAivace",1,0,0,1,2021-11-15
"QUIMACOVA","Redit_es",1,0,0,1,2021-11-15
"RachelRock2","aimplas",1,0,0,1,2021-11-15
"RachelRock2","GVAlabora",1,0,0,1,2021-11-15
"RamnBertNavarro","aimplas",1,0,0,1,2021-11-15
"RamnBertNavarro","Betelgeux_es",1,0,0,1,2021-11-15
"RamnBertNavarro","GVAavi",1,0,0,1,2021-11-15
"RamnBertNavarro","HospitalLaFe",1,0,0,1,2021-11-15
"RamnBertNavarro","ITQ_UPVCSIC",1,0,0,1,2021-11-15
"RamSG20","aimplas",1,0,0,1,2021-11-15
"RamSG20","Betelgeux_es",1,0,0,1,2021-11-15
"RamSG20","GVAavi",1,0,0,1,2021-11-15
"RamSG20","HospitalLaFe",1,0,0,1,2021-11-15
"RamSG20","ITQ_UPVCSIC",1,0,0,1,2021-11-15
"raorsamaq","aimplas",1,0,0,1,2021-11-15
"raorsamaq","Cicloplast_com",1,0,0,1,2021-11-15
"rappicupons105","aimplas",1,0,0,1,2021-11-15
"raqandu","aimplas",1,0,0,1,2021-11-15
"RececoEs","aimplas",1,0,0,1,2021-11-15
"RececoEs","esplasticos",1,0,0,1,2021-11-15
"RececoEs","IndustryTalksES",1,0,0,1,2021-11-15
"reciclajeFER","Aliciagfranco",1,0,0,1,2021-11-15
"reciclajeFER","AvepAsociacion",1,0,0,1,2021-11-15
"reciclajeFER","Cicloplast_com",1,0,0,1,2021-11-15
"RECOTRANS_H2020","AEMAC_",1,0,0,1,2021-11-15
"RECOTRANS_H2020","Arkema_group",1,0,0,1,2021-11-15
"RECOTRANS_H2020","Fraunhofer",1,0,0,1,2021-11-15
"Recuwaste","aimplas",1,0,0,1,2021-11-15
"Recuwaste","BASF_ES",1,0,0,1,2021-11-15
"Recuwaste","Petstarmx",1,0,0,1,2021-11-15
"Redit_es","3DPrinting_Des",1,0,0,1,2021-11-15
"Redit_es","Actecosl",1,0,0,1,2021-11-15
"Redit_es","Airbus",1,0,0,1,2021-11-15
"Redit_es","AMITMu_Val",1,0,0,1,2021-11-15
"Redit_es","ANAIP_es",1,0,0,1,2021-11-15
"Redit_es","AseTUB",1,0,0,1,2021-11-15
"Redit_es","asociacionruvid",1,0,0,1,2021-11-15
"Redit_es","AvepAsociacion",1,0,0,1,2021-11-15
"Redit_es","Baliht_EU",1,0,0,1,2021-11-15
"Redit_es","Bego_Pe",1,0,0,1,2021-11-15
"Redit_es","biofabrik",1,0,0,1,2021-11-15
"Redit_es","bioinicia",1,0,0,1,2021-11-15
"Redit_es","BIOnTop_Project",1,0,0,1,2021-11-15
"Redit_es","BIOVAL_es",1,0,0,1,2021-11-15
"Redit_es","Cajamar",1,0,0,1,2021-11-15
"Redit_es","CdeCarnica",1,0,0,1,2021-11-15
"Redit_es","CEPESCA",1,0,0,1,2021-11-15
"Redit_es","Cicloplast_com",1,0,0,1,2021-11-15
"Redit_es","ClusterFPrint",1,0,0,1,2021-11-15
"Redit_es","Colquimva",1,0,0,1,2021-11-15
"Redit_es","copecastellon",0,1,0,1,2021-11-15
"Redit_es","CORDIS_EU",1,0,0,1,2021-11-15
"Redit_es","CSICval",1,0,0,1,2021-11-15
"Redit_es","ed_cvalenciana",1,0,0,1,2021-11-15
"Redit_es","EuMarenco",1,0,0,1,2021-11-15
"Redit_es","Faurecia",1,0,0,1,2021-11-15
"Redit_es","FConexus",1,0,0,1,2021-11-15
"Redit_es","Fedit",1,0,0,1,2021-11-15
"Redit_es","fenin_es",1,0,0,1,2021-11-15
"Redit_es","Fira_Barcelona",1,0,0,1,2021-11-15
"Redit_es","Fritta_slu",1,0,0,1,2021-11-15
"Redit_es","GreenTurf",1,0,0,1,2021-11-15
"Redit_es","GVAddigital",1,0,0,1,2021-11-15
"Redit_es","horizonte2020",1,0,0,1,2021-11-15
"Redit_es","iberapa",1,0,0,1,2021-11-15
"Redit_es","IMDEAInstitutes",1,0,0,1,2021-11-15
"Redit_es","IzasaScientific",1,0,0,1,2021-11-15
"Redit_es","KerabenGrupo",1,0,0,1,2021-11-15
"Redit_es","KITKarlsruhe",1,0,0,1,2021-11-15
"Redit_es","LaFabricaDRadio",1,0,0,1,2021-11-15
"Redit_es","LafargeHolcimES",1,0,0,1,2021-11-15
"Redit_es","laprimerapiedra",1,0,0,1,2021-11-15
"Redit_es","levante_emv",1,0,0,1,2021-11-15
"Redit_es","NanomedSpain",1,0,0,1,2021-11-15
"Redit_es","Nestle_es",1,0,0,1,2021-11-15
"Redit_es","OceanetsProject",1,0,0,1,2021-11-15
"Redit_es","PacoCremades",1,0,0,1,2021-11-15
"Redit_es","Porcelanosa_es",1,0,0,1,2021-11-15
"Redit_es","prolabintefarm",1,0,0,1,2021-11-15
"Redit_es","PT3NEO",1,0,0,1,2021-11-15
"Redit_es","PTEPA1",1,0,0,1,2021-11-15
"Redit_es","ptprotecma",1,0,0,1,2021-11-15
"Redit_es","realturfoficial",1,0,0,1,2021-11-15
"Redit_es","ReciclaliaC",1,0,0,1,2021-11-15
"Redit_es","RecyclersEU",1,0,0,1,2021-11-15
"Redit_es","ReportsMarkets",1,0,0,1,2021-11-15
"Redit_es","RevistaRETEMA",1,0,0,1,2021-11-15
"Redit_es","seimedcv",1,0,0,1,2021-11-15
"Redit_es","sofitec_",1,0,0,1,2021-11-15
"Redit_es","Startup_VLC",1,0,0,1,2021-11-15
"Redit_es","tecnoalimen",1,0,0,1,2021-11-15
"Redit_es","UV_EG",1,0,0,1,2021-11-15
"REGEMAT3D","aimplas",1,0,0,1,2021-11-15
"Regmurcialimpia","ACCIONA",1,0,0,1,2021-11-15
"Regmurcialimpia","AerzenIberica",1,0,0,1,2021-11-15
"Regmurcialimpia","AlmarWater",1,0,0,1,2021-11-15
"Regmurcialimpia","AmbientalRM",1,0,0,1,2021-11-15
"Regmurcialimpia","ambienteeuropeo",0,1,0,1,2021-11-15
"Regmurcialimpia","asegre01",1,0,0,1,2021-11-15
"Regmurcialimpia","ASEMUPLAST",1,0,0,1,2021-11-15
"Regmurcialimpia","BASF_ES",1,0,0,1,2021-11-15
"Regmurcialimpia","CarmenFructuos4",1,0,0,1,2021-11-15
"Regmurcialimpia","CETAQUA",1,0,0,1,2021-11-15
"Regmurcialimpia","FCC_MA",1,0,0,1,2021-11-15
"Regmurcialimpia","FidelLopezSoria",1,0,0,1,2021-11-15
"Regmurcialimpia","gremirecupera",1,0,0,1,2021-11-15
"Regmurcialimpia","picvisa",1,0,0,1,2021-11-15
"Regmurcialimpia","recyclia",1,0,0,1,2021-11-15
"Regmurcialimpia","Repsol",1,0,0,1,2021-11-15
"Regmurcialimpia","SogamaXunta",1,0,0,1,2021-11-15
"Regmurcialimpia","SostenEconomica",1,0,0,1,2021-11-15
"Regmurcialimpia","suezES",1,0,0,1,2021-11-15
"Regmurcialimpia","TOMRARecycling",1,0,0,1,2021-11-15
"Regmurcialimpia","VeoliaWaterTech",1,0,0,1,2021-11-15
"REMADYL_EU","Circ_Flooring",1,0,0,1,2021-11-15
"REMADYL_EU","ENCOsrl",1,0,0,1,2021-11-15
"REMADYL_EU","EU_Commission",1,0,0,1,2021-11-15
"REMADYL_EU","EU_ecoinno",1,0,0,1,2021-11-15
"REMADYL_EU","EU_H2020",1,0,0,1,2021-11-15
"REMADYL_EU","FraunhoferICT",1,0,0,1,2021-11-15
"REMADYL_EU","ICMol_UV",1,0,0,1,2021-11-15
"REMADYL_EU","NanoMatFraunho1",1,0,0,1,2021-11-15
"REMADYL_EU","OVAM_Ecodesign",1,0,0,1,2021-11-15
"REMADYL_EU","project_react",1,0,0,1,2021-11-15
"REMADYL_EU","Promolding",1,0,0,1,2021-11-15
"REMADYL_EU","Vertech_Group",1,0,0,1,2021-11-15
"RepetCoinnova","esplasticos",1,0,0,1,2021-11-15
"residuorecurso","aimplas",1,0,0,1,2021-11-15
"ResiduosPro","AIDIMME",1,0,0,1,2021-11-15
"ResiduosPro","Cicloplast_com",1,0,0,1,2021-11-15
"ResiduosPro","GVAivace",1,0,0,1,2021-11-15
"ResiduosPro","InescopTech",1,0,0,1,2021-11-15
"ResiduosPro","ITC_ceramica",1,0,0,1,2021-11-15
"ResiduosPro","UV_EG",1,0,0,1,2021-11-15
"reverdeconcausa","aimplas",1,0,0,1,2021-11-15
"reverdeconcausa","canalsur",1,0,0,1,2021-11-15
"reverdeconcausa","ensgismau",1,0,0,1,2021-11-15
"reverdeconcausa","manavas21",1,0,0,1,2021-11-15
"reverdeconcausa","vir_montero",1,0,0,1,2021-11-15
"revista_PQ","ANAIP_es",1,0,0,1,2021-11-15
"revista_PQ","BactiBlock",1,0,0,1,2021-11-15
"revista_PQ","Cicloplast_com",1,0,0,1,2021-11-15
"revista_PQ","ENAC_acredita",1,0,0,1,2021-11-15
"revista_PQ","esplasticos",1,0,0,1,2021-11-15
"revista_PQ","Microban",1,0,0,1,2021-11-15
"revista_PQ","pharmamarket",1,0,0,1,2021-11-15
"revistaide","ainiatecnologia",1,0,0,1,2021-11-15
"revistaide","ANAIP_es",1,0,0,1,2021-11-15
"revistaide","ANARPLA",1,0,0,1,2021-11-15
"revistaide","AvepAsociacion",1,0,0,1,2021-11-15
"revistaide","PlasticsEuropES",1,0,0,1,2021-11-15
"revistaimcb","itenergia",1,0,0,1,2021-11-15
"RevistaMercados","ACES_supers",1,0,0,1,2021-11-15
"RevistaMercados","AECOC_ES",1,0,0,1,2021-11-15
"RevistaMercados","alcampo",1,0,0,1,2021-11-15
"RevistaMercados","AvepAsociacion",1,0,0,1,2021-11-15
"RevistaMercados","Benihort",1,0,0,1,2021-11-15
"RevistaMercados","Cicloplast_com",1,0,0,1,2021-11-15
"RevistaMercados","COEXPAN_",1,0,0,1,2021-11-15
"RevistaMercados","CoopsAgroCV",1,0,0,1,2021-11-15
"RevistaMercados","danone_es",1,0,0,1,2021-11-15
"RevistaMercados","Ecovalia",1,0,0,1,2021-11-15
"RevistaMercados","FEPEX_EU",1,0,0,1,2021-11-15
"RevistaMercados","PlasticsEuropES",1,0,0,1,2021-11-15
"RevistaRETEMA","AIDIMME",1,0,0,1,2021-11-15
"RevistaRETEMA","ainiatecnologia",1,0,0,1,2021-11-15
"RevistaRETEMA","ANAIP_es",1,0,0,1,2021-11-15
"RevistaRETEMA","AvepAsociacion",1,0,0,1,2021-11-15
"RevistaRETEMA","CIDETEC_",1,0,0,1,2021-11-15
"RevistaRETEMA","itenergia",1,0,0,1,2021-11-15
"RevistaRETEMA","PlasticsEuropES",1,0,0,1,2021-11-15
"RevistaRETEMA","recotrans",1,0,0,1,2021-11-15
"RevistaRETEMA","TOMRARecycling",1,0,0,1,2021-11-15
"RevistaRETEMA","UV_EG",1,0,0,1,2021-11-15
"rosamontesa","aimplas",1,0,0,1,2021-11-15
"rotoatlantica","aimplas",1,0,0,1,2021-11-15
"rotoatlantica","GVAivace",1,0,0,1,2021-11-15
"RPM_Plasticos","ANARPLA",1,0,0,1,2021-11-15
"RPM_Plasticos","BASF",1,0,0,1,2021-11-15
"RPM_Plasticos","Cicloplast_com",1,0,0,1,2021-11-15
"RPM_Plasticos","Colquimva",1,0,0,1,2021-11-15
"RPM_Plasticos","ITC_ceramica",1,0,0,1,2021-11-15
"RPM_Plasticos","PlasticsEurope",1,0,0,1,2021-11-15
"RPM_Plasticos","Repsol",1,0,0,1,2021-11-15
"RPM_Plasticos","SABIC",1,0,0,1,2021-11-15
"RSM_es","agrodhuelva",1,0,0,1,2021-11-15
"RSM_es","Alimarket",1,0,0,1,2021-11-15
"RSM_es","Tecnobebidas",1,0,0,1,2021-11-15
"RTVEValencia","AdrianaPrados",1,0,0,1,2021-11-15
"RTVEValencia","aimplas",1,0,0,1,2021-11-15
"RTVEValencia","GVAinnova",1,0,0,1,2021-11-15
"ruralpedia","AceiteOlivalle",1,0,0,1,2021-11-15
"ruralpedia","aimplas",1,0,0,1,2021-11-15
"sabadellprensa","aimplas",1,0,0,1,2021-11-15
"sabadellprensa","BancoSabadell",1,0,0,1,2021-11-15
"sabadellprensa","Grupo_Soledad",1,0,0,1,2021-11-15
"sabadellprensa","istobal_es",1,0,0,1,2021-11-15
"sabadellprensa","levante_emv",1,0,0,1,2021-11-15
"SagredoMarco","DarwinBioprosp",1,0,0,1,2021-11-15
"SagredoMarco","InescopTech",1,0,0,1,2021-11-15
"SagredoMarco","ITC_ceramica",1,0,0,1,2021-11-15
"SagredoMarco","SagredoMarco",0,0,1,1,2021-11-15
"Saludes_Ind","aimplas",1,0,0,1,2021-11-15
"Saludes_Ind","ibv_org",1,0,0,1,2021-11-15
"Saludes_Ind","LaPinadaLab",1,0,0,1,2021-11-15
"Saludes_Ind","uchceu",1,0,0,1,2021-11-15
"Saludes_Ind","UPV",1,0,0,1,2021-11-15
"Saludes_Ind","WDCValencia2022",1,0,0,1,2021-11-15
"saludes_play","aimplas",1,0,0,1,2021-11-15
"saludes_play","GVAivace",1,0,0,1,2021-11-15
"saludes_play","itenergia",1,0,0,1,2021-11-15
"Sam_felix","AIDIMME",1,0,0,1,2021-11-15
"Sam_felix","aimplas",1,0,0,1,2021-11-15
"Sam_felix","Avia_automocion",1,0,0,1,2021-11-15
"Sam_felix","HP",1,0,0,1,2021-11-15
"Sam_felix","sernauto",1,0,0,1,2021-11-15
"Santa_Teresa","aimplas",1,0,0,1,2021-11-15
"Santa_Teresa","FGULEM",1,0,0,1,2021-11-15
"Santa_Teresa","fgusal",1,0,0,1,2021-11-15
"Santa_Teresa","Fundacion_CTME",1,0,0,1,2021-11-15
"Santa_Teresa","FundacionUBU",1,0,0,1,2021-11-15
"Santa_Teresa","fungeuva",1,0,0,1,2021-11-15
"Santa_Teresa","Santa_Teresa",1,0,0,1,2021-11-15
"sapiensenergia","aimplas",1,0,0,1,2021-11-15
"sapiensenergia","GVAivace",1,0,0,1,2021-11-15
"sapiensenergia","itenergia",1,0,0,1,2021-11-15
"SDDR_info","aimplas",1,0,0,1,2021-11-15
"SDDR_info","ANARPLA",1,0,0,1,2021-11-15
"SDDR_info","Cicloplast_com",1,0,0,1,2021-11-15
"SDDR_info","cogersaasturias",1,0,0,1,2021-11-15
"SDDR_info","cogersacatedra",1,0,0,1,2021-11-15
"SDDR_info","DriadeSM",1,0,0,1,2021-11-15
"SDDR_info","gremirecupera",1,0,0,1,2021-11-15
"SDDR_info","mitecogob",1,0,0,1,2021-11-15
"SDDR_info","residuscat",1,0,0,1,2021-11-15
"SDDR_info","SDDR_info",0,1,0,1,2021-11-15
"SDDR_info","SogamaXunta",1,0,0,1,2021-11-15
"SDDR_info","Vertidos_Cero",1,0,0,1,2021-11-15
"segacases","aimplas",1,0,0,1,2021-11-15
"segacases","AvepAsociacion",1,0,0,1,2021-11-15
"segacases","GrupoGPS_sefh",1,0,0,1,2021-11-15
"segacases","micofvlc",1,0,0,1,2021-11-15
"seimedcv","aimplas",1,0,0,1,2021-11-15
"seimedcv","CentrosCex",0,1,0,1,2021-11-15
"seimedcv","GVAivace",1,0,0,1,2021-11-15
"seimedcv","Redit_es",1,0,0,1,2021-11-15
"SemanaRSC","aimplas",1,0,0,1,2021-11-15
"SemanaRSC","Apambu_",1,0,0,1,2021-11-15
"SemanaRSC","AsisaSalud",1,0,0,1,2021-11-15
"SemanaRSC","BSABadalona",1,0,0,1,2021-11-15
"SemanaRSC","crearsa",1,0,0,1,2021-11-15
"SemanaRSC","Desconnexions",1,0,0,1,2021-11-15
"SemanaRSC","Expok",1,0,0,1,2021-11-15
"SemanaRSC","FELGTB",1,0,0,1,2021-11-15
"SemanaRSC","gngroup",1,0,0,1,2021-11-15
"SemanaRSC","hiltondiagonal",1,0,0,1,2021-11-15
"SemanaRSC","KLM_ES",1,0,0,1,2021-11-15
"SemanaRSC","LaCalaixera",1,0,0,1,2021-11-15
"SemanaRSC","omplim",1,0,0,1,2021-11-15
"SemanaRSC","tossalloficial",1,0,0,1,2021-11-15
"silviaavilesg","AdvanFactories",1,0,0,1,2021-11-15
"silviaavilesg","AEMAC_",1,0,0,1,2021-11-15
"silviaavilesg","Airbus",1,0,0,1,2021-11-15
"silviaavilesg","ANAIP_es",1,0,0,1,2021-11-15
"silviaavilesg","CDTIoficial",1,0,0,1,2021-11-15
"silviaavilesg","DANOBATGROUP",1,0,0,1,2021-11-15
"silviaavilesg","Redit_es",1,0,0,1,2021-11-15
"silviaavilesg","TalgoGroup",1,0,0,1,2021-11-15
"silviaavilesg","UdGPolitecnica",1,0,0,1,2021-11-15
"skrollerbelt","aimplas",1,0,0,1,2021-11-15
"skrollerbelt","corifyAF",1,0,0,1,2021-11-15
"skrollerbelt","Grupo_TSK",1,0,0,1,2021-11-15
"skrollerbelt","Molecor",1,0,0,1,2021-11-15
"skrollerbelt","PigCHAMP_Europa",1,0,0,1,2021-11-15
"skrollerbelt","PlatinoEduca",1,0,0,1,2021-11-15
"SoniaHe49592177","aimplas",1,0,0,1,2021-11-15
"SoniaHe49592177","Betelgeux_es",1,0,0,1,2021-11-15
"SoniaHe49592177","GVAavi",1,0,0,1,2021-11-15
"SoniaHe49592177","HospitalLaFe",1,0,0,1,2021-11-15
"SoniaHe49592177","ITQ_UPVCSIC",1,0,0,1,2021-11-15
"SoniTirado","generalitat",1,0,0,1,2021-11-15
"SpainBiz_Japan","aimplas",1,0,0,1,2021-11-15
"SpainBiz_Japan","BlueplasmaPower",1,0,0,1,2021-11-15
"SphereSpain","aimplas",1,0,0,1,2021-11-15
"SphereSpain","ANAIP_es",1,0,0,1,2021-11-15
"SphereSpain","esplasticos",1,0,0,1,2021-11-15
"ssuchy_eu","aimplas",1,0,0,1,2021-11-15
"ssuchy_eu","cleansky_ju",1,0,0,1,2021-11-15
"ssuchy_eu","JECComposites",0,1,0,1,2021-11-15
"ssuchy_eu","TNO_Research",1,0,0,1,2021-11-15
"Startup_VLC","aganovagrupo",1,0,0,1,2021-11-15
"Startup_VLC","aimplas",1,0,0,1,2021-11-15
"Startup_VLC","angelramire",1,0,0,1,2021-11-15
"Startup_VLC","EosOrbital",1,0,0,1,2021-11-15
"Startup_VLC","GlobalOmnium",1,0,0,1,2021-11-15
"Startup_VLC","GoHubTech",1,0,0,1,2021-11-15
"Startup_VLC","JuanPeaIbaez2",1,0,0,1,2021-11-15
"Startup_VLC","LinkenerSpain",1,0,0,1,2021-11-15
"Startup_VLC","pepesiega",1,0,0,1,2021-11-15
"SusanaPBadal","aimplas",1,0,0,1,2021-11-15
"SusanaPBadal","GVAavi",1,0,0,1,2021-11-15
"SusanaPBadal","ITC_Packaging",1,0,0,1,2021-11-15
"SusanaPBadal","marsanpa",1,0,0,1,2021-11-15
"SusChemSpain","Airbus",1,0,0,1,2021-11-15
"SusChemSpain","Cefic",1,0,0,1,2021-11-15
"SusChemSpain","foretica",1,0,0,1,2021-11-15
"SusChemSpain","omenendez",1,0,0,1,2021-11-15
"SusChemSpain","Pascual",1,0,0,1,2021-11-15
"SusChemSpain","SusChemSpain",1,0,0,1,2021-11-15
"SusChemSpain","ternua",1,0,0,1,2021-11-15
"SUST4IN","aimplas",1,0,0,1,2021-11-15
"SUST4IN","FuturEnviro",1,0,0,1,2021-11-15
"SustainPlastics","kpGroup_",1,0,0,1,2021-11-15
"tabitbilisim","aimplas",1,0,0,1,2021-11-15
"tabitbilisim","azmud",1,0,0,1,2021-11-15
"tabitbilisim","idainature",1,0,0,1,2021-11-15
"tabitbilisim","prima",1,0,0,1,2021-11-15
"talk2much12","accio_cat",1,0,0,1,2021-11-15
"talk2much12","aimplas",1,0,0,1,2021-11-15
"talk2much12","AristosInfo",1,0,0,1,2021-11-15
"talk2much12","biocat_cat",1,0,0,1,2021-11-15
"talk2much12","CDTIoficial",1,0,0,1,2021-11-15
"talk2much12","eencat",1,0,0,1,2021-11-15
"talk2much12","Eurecat_news",1,0,0,1,2021-11-15
"talk2much12","horizonexperts",1,0,0,1,2021-11-15
"talk2much12","IreneLarroy",1,0,0,1,2021-11-15
"talk2much12","JCGarcia_CDTI",1,0,0,1,2021-11-15
"talk2much12","jordipietx",1,0,0,1,2021-11-15
"talk2much12","RosaAriasAlv",1,0,0,1,2021-11-15
"talk2much12","scibus",1,0,0,1,2021-11-15
"talk2much12","SorosGabinete",1,0,0,1,2021-11-15
"talk2much12","Wendy_Moreno_EU",1,0,0,1,2021-11-15
"tecnalia","AgEInves",1,0,0,1,2021-11-15
"tecnalia","aimplas",1,0,0,1,2021-11-15
"tecnalia","FunditecOrg",1,0,0,1,2021-11-15
"tecnalia","incarCSIC",1,0,0,1,2021-11-15
"tecnalia","tecnalia",1,0,0,1,2021-11-15
"tecnalia","ualmeria",1,0,0,1,2021-11-15
"Tecnifood","ainiatecnologia",1,0,0,1,2021-11-15
"Tecnifood","ANAIP_es",1,0,0,1,2021-11-15
"Tecnifood","Cicloplast_com",1,0,0,1,2021-11-15
"Tecnifood","danone_es",1,0,0,1,2021-11-15
"Tecnifood","esplasticos",1,0,0,1,2021-11-15
"Tecnifood","expoquimia",1,0,0,1,2021-11-15
"Tecnifood","faerchgroup",1,0,0,1,2021-11-15
"Tecnifood","GVAivace",1,0,0,1,2021-11-15
"Tecnifood","ITI_TIC",1,0,0,1,2021-11-15
"Tecnifood","Nestle_es",1,0,0,1,2021-11-15
"Tecnifood","Penn",1,0,0,1,2021-11-15
"Tecnifood","PlasticsEuropES",1,0,0,1,2021-11-15
"Tecnifood","Tecnifood",1,0,0,1,2021-11-15
"Tecnifood","UNALOficial",1,0,0,1,2021-11-15
"tecnoaqua","aimplas",1,0,0,1,2021-11-15
"tecnopackaging","aacudam",1,0,0,1,2021-11-15
"tecnopackaging","AgroBioCluster",1,0,0,1,2021-11-15
"tecnopackaging","aimplas",1,0,0,1,2021-11-15
"tecnopackaging","CIDETEC_",1,0,0,1,2021-11-15
"tecnopackaging","FarrellyMitchel",1,0,0,1,2021-11-15
"tecnopackaging","GenHydro",1,0,0,1,2021-11-15
"tecnopackaging","GreenovateEU",1,0,0,1,2021-11-15
"tecnopackaging","mi_sustainable",1,0,0,1,2021-11-15
"tecnopackaging","RISEProcessum",1,0,0,1,2021-11-15
"tecnopackaging","tecnopackaging",0,0,1,1,2021-11-15
"TeknikerOficial","20m",1,0,0,1,2021-11-15
"TeknikerOficial","aimplas",1,0,0,1,2021-11-15
"ter4bithi4","BASF_ES",1,0,0,1,2021-11-15
"ter4bithi4","CDTIoficial",1,0,0,1,2021-11-15
"ter4bithi4","Cefic",1,0,0,1,2021-11-15
"ter4bithi4","deborahciencia",1,0,0,1,2021-11-15
"ter4bithi4","EsAirbus",1,0,0,1,2021-11-15
"ter4bithi4","EsHorizonte2020",1,0,0,1,2021-11-15
"ter4bithi4","Feique_ES",1,0,0,1,2021-11-15
"ter4bithi4","foretica",1,0,0,1,2021-11-15
"ter4bithi4","omenendez",1,0,0,1,2021-11-15
"ter4bithi4","Pascual",1,0,0,1,2021-11-15
"ter4bithi4","Repsol",1,0,0,1,2021-11-15
"ter4bithi4","SABIC",1,0,0,1,2021-11-15
"ter4bithi4","SusChemSpain",1,0,0,1,2021-11-15
"ter4bithi4","ter4bithi4",0,0,1,1,2021-11-15
"ter4bithi4","ternua",1,0,0,1,2021-11-15
"terenet","aimplas",1,0,0,1,2021-11-15
"terenet","artsolut",1,0,0,1,2021-11-15
"terenet","dipMurcia",1,0,0,1,2021-11-15
"terenet","EssentraPackES",1,0,0,1,2021-11-15
"terenet","Foro_READ",1,0,0,1,2021-11-15
"terenet","itene",1,0,0,1,2021-11-15
"TeximInfo","addimat",1,0,0,1,2021-11-15
"TeximInfo","AvepAsociacion",1,0,0,1,2021-11-15
"TeximInfo","ibv_org",1,0,0,1,2021-11-15
"TeximInfo","TechExcelencia",1,0,0,1,2021-11-15
"TheCircularLab","aimplas",1,0,0,1,2021-11-15
"TheCircularLab","ecoticiasRED",1,0,0,1,2021-11-15
"TheCircularLab","GVAivace",1,0,0,1,2021-11-15
"TifasGalicia","aimplas",1,0,0,1,2021-11-15
"TifasGalicia","GVAivace",1,0,0,1,2021-11-15
"Titania_aero","aimplas",1,0,0,1,2021-11-15
"Titania_aero","CTengineers",1,0,0,1,2021-11-15
"Titania_aero","Inespasa_",1,0,0,1,2021-11-15
"TitoCrissien","TitoCrissien",0,0,1,1,2021-11-15
"TRAKTECH_","ainiatecnologia",1,0,0,1,2021-11-15
"TRAKTECH_","ANAIP_es",1,0,0,1,2021-11-15
"TRAKTECH_","ANARPLA",1,0,0,1,2021-11-15
"TRAKTECH_","Cicloplast_com",1,0,0,1,2021-11-15
"TRAKTECH_","expoquimia",1,0,0,1,2021-11-15
"TRAKTECH_","gremirecupera",1,0,0,1,2021-11-15
"TRAKTECH_","LAB_Ecoinnova",1,0,0,1,2021-11-15
"TRAKTECH_","PlasticsEurope",1,0,0,1,2021-11-15
"TRAKTECH_","Suruscircular",1,0,0,1,2021-11-15
"ucvalencia","AIDIMME",1,0,0,1,2021-11-15
"ucvalencia","AIJU_Tecnologi",1,0,0,1,2021-11-15
"ucvalencia","aimplas",1,0,0,1,2021-11-15
"ucvalencia","ainiatecnologia",1,0,0,1,2021-11-15
"ucvalencia","aitex_es",1,0,0,1,2021-11-15
"ucvalencia","ibv_org",1,0,0,1,2021-11-15
"ucvalencia","InescopTech",1,0,0,1,2021-11-15
"ucvalencia","ITC_ceramica",1,0,0,1,2021-11-15
"ucvalencia","itene",1,0,0,1,2021-11-15
"ucvalencia","itenergia",1,0,0,1,2021-11-15
"ucvalencia","ITI_TIC",1,0,0,1,2021-11-15
"UniElectrica","aimplas",1,0,0,1,2021-11-15
"UNLOCK_BBI","aacudam",1,0,0,1,2021-11-15
"UNLOCK_BBI","AgroBioCluster",1,0,0,1,2021-11-15
"UNLOCK_BBI","CIDETEC_",1,0,0,1,2021-11-15
"UNLOCK_BBI","FarrellyMitchel",1,0,0,1,2021-11-15
"UNLOCK_BBI","GenHydro",1,0,0,1,2021-11-15
"UNLOCK_BBI","GreenovateEU",1,0,0,1,2021-11-15
"UNLOCK_BBI","mi_sustainable",1,0,0,1,2021-11-15
"UNLOCK_BBI","RISEProcessum",1,0,0,1,2021-11-15
"UNLOCK_BBI","tecnopackaging",1,0,0,1,2021-11-15
"UNLOCK_BBI","unlock",1,0,0,1,2021-11-15
"UPLIFT_EU","CristianoVarro2",1,0,0,1,2021-11-15
"UPLIFT_EU","Equiplast",1,0,0,1,2021-11-15
"UPLIFT_EU","EU_H2020",1,0,0,1,2021-11-15
"UPLIFT_EU","EU_HaDEA",1,0,0,1,2021-11-15
"UPLIFT_EU","fpffoundation",1,0,0,1,2021-11-15
"UPLIFT_EU","H2020GreenDeal",1,0,0,1,2021-11-15
"UPLIFT_EU","lapalmaresearch",1,0,0,1,2021-11-15
"UPLIFT_EU","MacaronightEU",1,0,0,1,2021-11-15
"UprofesValencia","aimplas",1,0,0,1,2021-11-15
"UprofesValencia","Colquimva",1,0,0,1,2021-11-15
"valenciactiva_","aimplas",1,0,0,1,2021-11-15
"valenciactiva_","valenciactiva_",0,0,1,1,2021-11-15
"VAtradu","aimplas",1,0,0,1,2021-11-15
"veredictas","alabrent_mag",1,0,0,1,2021-11-15
"veredictas","Albert_Margalef",1,0,0,1,2021-11-15
"veredictas","ESDi_Barcelona",1,0,0,1,2021-11-15
"veredictas","iptriana",1,0,0,1,2021-11-15
"veredictas","Kaitxo2017",1,0,0,1,2021-11-15
"veredictas","MauricioCarret6",1,0,0,1,2021-11-15
"Vermican","aimplas",1,0,0,1,2021-11-15
"Vermican","Benihort",1,0,0,1,2021-11-15
"Vermican","IBMCP",1,0,0,1,2021-11-15
"Vertidos_Cero","EstrellaDammCat",1,0,0,1,2021-11-15
"Vertidos_Cero","EstrellaDammEs",1,0,0,1,2021-11-15
"Vertidos_Cero","EU_MARE",0,1,0,1,2021-11-15
"Vertidos_Cero","MasMineria",1,0,0,1,2021-11-15
"Vertidos_Cero","prendente",1,0,0,1,2021-11-15
"Vertidos_Cero","rtve",1,0,0,1,2021-11-15
"VicenteAbella","aimplas",1,0,0,1,2021-11-15
"VicenteAbella","VAtradu",1,0,0,1,2021-11-15
"vincenzo_gente","EU_EASME",1,0,0,1,2021-11-15
"vincenzo_gente","EU_MARE",1,0,0,1,2021-11-15
"vincenzo_gente","OceanetsProject",1,0,0,1,2021-11-15
"VirtualWalcon","aimplas",1,0,0,1,2021-11-15
"VirtualWalcon","Cicloplast_com",1,0,0,1,2021-11-15
"VirtualWalcon","VirtualWalcon",1,0,0,1,2021-11-15
"VLCTechCity","AIDIMME",1,0,0,1,2021-11-15
"VLCTechCity","ainiatecnologia",1,0,0,1,2021-11-15
"VLCTechCity","belenfranchgras",1,0,0,1,2021-11-15
"VLCTechCity","cdcampo1",1,0,0,1,2021-11-15
"VLCTechCity","FGlobalNature",1,0,0,1,2021-11-15
"VLCTechCity","GVAivace",1,0,0,1,2021-11-15
"VLCTechCity","InescopTech",1,0,0,1,2021-11-15
"VLCTechCity","levante_emv",1,0,0,1,2021-11-15
"VLCTechCity","VLCTechCity",0,0,1,1,2021-11-15
"WaystupH2020","ETAM_SA",1,0,0,1,2021-11-15
"WaystupH2020","TerraiXufaRSSFA",1,0,0,1,2021-11-15
"WriterAlejandro","aimplas",1,0,0,1,2021-11-15
"WriterAlejandro","BBI2020",1,0,0,1,2021-11-15
"WriterAlejandro","biconsortium",1,0,0,1,2021-11-15
"WriterAlejandro","BioVale_Cluster",1,0,0,1,2021-11-15
"WriterAlejandro","BPF_pilotplant",1,0,0,1,2021-11-15
"WriterAlejandro","coopagrariesCAT",1,0,0,1,2021-11-15
"WriterAlejandro","EU_H2020",1,0,0,1,2021-11-15
"WriterAlejandro","InnoconsultLc",1,0,0,1,2021-11-15
"WriterAlejandro","iris_rd",1,0,0,1,2021-11-15
"WriterAlejandro","irtacat",1,0,0,1,2021-11-15
"WriterAlejandro","mogumycelium",1,0,0,1,2021-11-15
"WriterAlejandro","ualmeria",1,0,0,1,2021-11-15
"WriterAlejandro","UniboMagazine",1,0,0,1,2021-11-15
"xemagil","aimplas",1,0,0,1,2021-11-15
"xemagil","Arturolarena",1,0,0,1,2021-11-15
"xemagil","BelenFranch",1,0,0,1,2021-11-15
"ximogorriz","aimplas",1,0,0,1,2021-11-15
"ximogorriz","AndresGReche",1,0,0,1,2021-11-15
"ximogorriz","espaitec",1,0,0,1,2021-11-15
"ximogorriz","GVAavi",1,0,0,1,2021-11-15
"ximogorriz","jesus_lancis",1,0,0,1,2021-11-15
"ximogorriz","MosaikUrbanSys",1,0,0,1,2021-11-15
"ximogorriz","SchneiderES",1,0,0,1,2021-11-15
"ximogorriz","SGS_Spain",1,0,0,1,2021-11-15
"ximogorriz","UJIuniversitat",1,0,0,1,2021-11-15
"yudani_yudani","aimplas",1,0,0,1,2021-11-15
"yudani_yudani","ArviInnovapesca",1,0,0,1,2021-11-15
"yudani_yudani","CEPESCA",1,0,0,1,2021-11-15
"yudani_yudani","JJChicolino",1,0,0,1,2021-11-15
"yudani_yudani","MarineInstrumen",1,0,0,1,2021-11-15
"yudani_yudani","mitecogob",1,0,0,1,2021-11-15
"yudani_yudani","PTEPA1",1,0,0,1,2021-11-15
"yudani_yudani","ptprotecma",1,0,0,1,2021-11-15
"yudani_yudani","PuertoDeVigo",1,0,0,1,2021-11-15
"zicla_eus","aimplas",1,0,0,1,2021-11-15
"zicla_eus","InescopTech",1,0,0,1,2021-11-15
"zicla_eus","RevistaRETEMA",1,0,0,1,2021-11-15
"zoomtvcordoba","AceiteOlivalle",1,0,0,1,2021-11-15
"zoomtvcordoba","aimplas",1,0,0,1,2021-11-15
