"source","destinations","mention","quote","reply","weight","DateUpdate"
"Redit_es","aimplas",398,1,2,401,2021-11-26
"Redit_es","ainiatecnologia",221,0,0,221,2021-11-26
"Redit_es","ITC_ceramica",217,0,2,219,2021-11-26
"Redit_es","AIDIMME",216,0,0,216,2021-11-26
"Redit_es","ITI_TIC",216,0,0,216,2021-11-26
"Redit_es","aitex_es",207,0,0,207,2021-11-26
"Redit_es","itenergia",196,0,0,196,2021-11-26
"TeximInfo","aimplas",97,0,97,194,2021-11-26
"Redit_es","AIJU_Tecnologi",191,0,0,191,2021-11-26
"Redit_es","InescopTech",187,0,0,187,2021-11-26
"Redit_es","ibv_org",184,0,0,184,2021-11-26
"Redit_es","itene",182,0,0,182,2021-11-26
"Redit_es","Redit_es",131,0,0,131,2021-11-26
"izarotech","aimplas",66,0,29,95,2021-11-26
"FuturEnviro","aimplas",76,0,0,76,2021-11-26
"RevistaRETEMA","aimplas",62,0,0,62,2021-11-26
"Mundoplast","aimplas",59,0,0,59,2021-11-26
"aimplas","aimplas",50,0,8,58,2021-11-26
"Redit_es","GVAavi",56,0,0,56,2021-11-26
"Redit_es","GVAivace",54,0,2,56,2021-11-26
"Packnet_","aimplas",35,8,8,51,2021-11-26
"ForoQyS","aimplas",30,0,15,45,2021-11-26
"Redit_es","GVAinnova",39,0,0,39,2021-11-26
"expoquimia","aimplas",37,0,0,37,2021-11-26
"AEMAC_","aimplas",33,0,1,34,2021-11-26
"RPM_Plasticos","aimplas",34,0,0,34,2021-11-26
"UPLIFT_EU","aimplas",34,0,0,34,2021-11-26
"UPLIFT_EU","UPLIFT_EU",2,0,32,34,2021-11-26
"CentrosCex","aimplas",22,0,11,33,2021-11-26
"veredictas","CEPplast",32,0,1,33,2021-11-26
"UPLIFT_EU","Bioplastech",32,0,0,32,2021-11-26
"UPLIFT_EU","DTUtweet",32,0,0,32,2021-11-26
"UPLIFT_EU","es_aau",32,0,0,32,2021-11-26
"UPLIFT_EU","fz_juelich",32,0,0,32,2021-11-26
"UPLIFT_EU","LeibnizHKI",32,0,0,32,2021-11-26
"UPLIFT_EU","Lundsuni",32,0,0,32,2021-11-26
"UPLIFT_EU","mi_sustainable",32,0,0,32,2021-11-26
"UPLIFT_EU","RWTH",32,0,0,32,2021-11-26
"UPLIFT_EU","SustainableInnE",32,0,0,32,2021-11-26
"UPLIFT_EU","TECNARO_GmbH",32,0,0,32,2021-11-26
"UPLIFT_EU","ucdgaeltacht",32,0,0,32,2021-11-26
"UPLIFT_EU","Vestforbranding",32,0,0,32,2021-11-26
"veredictas","aimplas",32,0,0,32,2021-11-26
"veredictas","ANARPLA",32,0,0,32,2021-11-26
"veredictas","ClubMktBcn",32,0,0,32,2021-11-26
"veredictas","Digicomexpo",32,0,0,32,2021-11-26
"veredictas","elpublicistacom",32,0,0,32,2021-11-26
"veredictas","Envaspres",32,0,0,32,2021-11-26
"veredictas","IPMARK",32,0,0,32,2021-11-26
"veredictas","itene",32,0,0,32,2021-11-26
"veredictas","RevistaInfopack",32,0,0,32,2021-11-26
"EPPM_Magazine","aimplas",30,0,0,30,2021-11-26
"veredictas","revistaide",30,0,0,30,2021-11-26
"veredictas","Tecnifood",30,0,0,30,2021-11-26
"ainiatecnologia","aimplas",29,0,0,29,2021-11-26
"GVAavi","aimplas",28,0,0,28,2021-11-26
"i_plastico","aimplas",28,0,0,28,2021-11-26
"UPLIFT_EU","europatweets",28,0,0,28,2021-11-26
"UPLIFT_EU","EU_Commission",27,0,0,27,2021-11-26
"PlasticFV","aimplas",21,0,4,25,2021-11-26
"revistaide","aimplas",19,0,6,25,2021-11-26
"Tecnifood","aimplas",24,0,1,25,2021-11-26
"pharmamarket","aimplas",24,0,0,24,2021-11-26
"Equiplast","aimplas",23,0,0,23,2021-11-26
"ait_research","aimplas",21,0,1,22,2021-11-26
"ANAIP_es","aimplas",21,0,1,22,2021-11-26
"ambientplastico","aimplas",19,0,2,21,2021-11-26
"expoquimia","accio_cat",21,0,0,21,2021-11-26
"Alvaro_Eslu","aimplas",17,0,3,20,2021-11-26
"expoquimia","IREC_Energia",20,0,0,20,2021-11-26
"Fedit","aimplas",14,4,2,20,2021-11-26
"AvepAsociacion","aimplas",18,1,0,19,2021-11-26
"BIOVAL_es","aimplas",18,0,1,19,2021-11-26
"FuturEnviro","FuturEnviro",15,1,3,19,2021-11-26
"emprenemjunts","aimplas",18,0,0,18,2021-11-26
"ResiduosPro","aimplas",18,0,0,18,2021-11-26
"UPLIFT_EU","t_uppe",18,0,0,18,2021-11-26
"Regmurcialimpia","aimplas",15,0,2,17,2021-11-26
"SustainPlastics","aimplas",17,0,0,17,2021-11-26
"davidorreta","aimplas",16,0,0,16,2021-11-26
"davidorreta","ResiduosPro",16,0,0,16,2021-11-26
"ceeivalencia","aimplas",15,0,0,15,2021-11-26
"PlasticsEuropES","aimplas",14,1,0,15,2021-11-26
"aec_es","aimplas",13,1,0,14,2021-11-26
"ait_research","BioICEP_IMGGE",13,1,0,14,2021-11-26
"Eurosurfas","aimplas",14,0,0,14,2021-11-26
"int_quimica","aimplas",14,0,0,14,2021-11-26
"ITC_ceramica","aimplas",14,0,0,14,2021-11-26
"itenergia","GVAivace",14,0,0,14,2021-11-26
"eurocarne","aimplas",11,0,2,13,2021-11-26
"itenergia","aimplas",13,0,0,13,2021-11-26
"OceanetsProject","aimplas",12,1,0,13,2021-11-26
"AEMAC_","FIDAMC_",12,0,0,12,2021-11-26
"ait_research","FournetMargaret",11,0,1,12,2021-11-26
"CdeCarnica","aimplas",11,0,1,12,2021-11-26
"expoquimia","Leitat",12,0,0,12,2021-11-26
"Redit_es","valenciactiva_",12,0,0,12,2021-11-26
"Hispackbcn","aimplas",11,0,0,11,2021-11-26
"ibv_org","aimplas",11,0,0,11,2021-11-26
"Regmurcialimpia","Vertidos_Cero",9,0,2,11,2021-11-26
"somoscidec","aimplas",11,0,0,11,2021-11-26
"ait_research","ambercentre",10,0,0,10,2021-11-26
"ait_research","RDI_at_LIT",10,0,0,10,2021-11-26
"CentrosCex","OceanetsProject",10,0,0,10,2021-11-26
"Cicloplast_com","aimplas",10,0,0,10,2021-11-26
"expoquimia","harvestoreEU",10,0,0,10,2021-11-26
"expoquimia","la_UPC",10,0,0,10,2021-11-26
"expoquimia","linknovate",10,0,0,10,2021-11-26
"expoquimia","RECOTRANS_H2020",10,0,0,10,2021-11-26
"GVAivace","aimplas",10,0,0,10,2021-11-26
"iResiduo","aimplas",10,0,0,10,2021-11-26
"PLABUNsrl","aimplas",10,0,0,10,2021-11-26
"pteco2","aimplas",9,1,0,10,2021-11-26
"Vertidos_Cero","aimplas",10,0,0,10,2021-11-26
"AEMAC_","Eurecat_news",9,0,0,9,2021-11-26
"anacanoarribas","CoopsAgroCV",7,0,2,9,2021-11-26
"AvepAsociacion","ANAIP_es",9,0,0,9,2021-11-26
"AvepAsociacion","ANARPLA",9,0,0,9,2021-11-26
"AvepAsociacion","AvepAsociacion",9,0,0,9,2021-11-26
"AvepAsociacion","Cicloplast_com",9,0,0,9,2021-11-26
"CentrosCex","corifyAF",9,0,0,9,2021-11-26
"CentrosCex","Grupo_TSK",9,0,0,9,2021-11-26
"CentrosCex","Molecor",9,0,0,9,2021-11-26
"CentrosCex","PigCHAMP_Europa",9,0,0,9,2021-11-26
"CentrosCex","PlatinoEduca",9,0,0,9,2021-11-26
"CentrosCex","skrollerbelt",9,0,0,9,2021-11-26
"esplasticos","aimplas",9,0,0,9,2021-11-26
"expoquimia","ICIQchem",9,0,0,9,2021-11-26
"fadiplastsl","aimplas",5,0,4,9,2021-11-26
"fruittoday","aimplas",9,0,0,9,2021-11-26
"GVAavi","Actecosl",9,0,0,9,2021-11-26
"GVAavi","realturfoficial",9,0,0,9,2021-11-26
"GVAivace","Julia_company",9,0,0,9,2021-11-26
"GVAivace","Redit_es",9,0,0,9,2021-11-26
"int_envase","aimplas",9,0,0,9,2021-11-26
"MaripeSamper","skrollerbelt",8,0,1,9,2021-11-26
"OCRValencia","aimplas",8,0,1,9,2021-11-26
"PlasticsWorld","aimplas",9,0,0,9,2021-11-26
"RevistaMercados","aimplas",9,0,0,9,2021-11-26
"UPLIFT_EU","BioICEP_H2020",9,0,0,9,2021-11-26
"Vertidos_Cero","Vertidos_Cero",7,0,2,9,2021-11-26
"AEMAC_","aeroespacialUPM",8,0,0,8,2021-11-26
"AvepAsociacion","PlasticsEuropES",8,0,0,8,2021-11-26
"Equiplast","Leitat",8,0,0,8,2021-11-26
"Eurosurfas","accio_cat",8,0,0,8,2021-11-26
"expoquimia","gremirecupera",8,0,0,8,2021-11-26
"expoquimia","LAB_Ecoinnova",8,0,0,8,2021-11-26
"expoquimia","Suruscircular",8,0,0,8,2021-11-26
"GVAivace","Rafa_Climentg",8,0,0,8,2021-11-26
"HABRILAN","AEMAC_",4,4,0,8,2021-11-26
"industry_arena","aimplas",8,0,0,8,2021-11-26
"ITC_ceramica","AIDIMME",8,0,0,8,2021-11-26
"ITC_ceramica","Redit_es",5,1,2,8,2021-11-26
"OceanetsProject","OceanetsProject",4,0,4,8,2021-11-26
"SagredoMarco","aimplas",8,0,0,8,2021-11-26
"silviaavilesg","aimplas",8,0,0,8,2021-11-26
"SusChemSpain","aimplas",8,0,0,8,2021-11-26
"SusChemSpain","deborahciencia",7,1,0,8,2021-11-26
"WaystupH2020","aimplas",8,0,0,8,2021-11-26
"_asobiocom","aimplas",7,0,0,7,2021-11-26
"ait_research","AitLibrary",7,0,0,7,2021-11-26
"anacanoarribas","aimplas",7,0,0,7,2021-11-26
"Azmudeu","aimplas",7,0,0,7,2021-11-26
"Azmudeu","idainature",7,0,0,7,2021-11-26
"Azmudeu","tabitbilisim",7,0,0,7,2021-11-26
"BeonNAT_H2020","aimplas",6,0,1,7,2021-11-26
"ceeivalencia","ainiatecnologia",7,0,0,7,2021-11-26
"ceeivalencia","BIOVAL_es",7,0,0,7,2021-11-26
"ceeivalencia","itene",7,0,0,7,2021-11-26
"ceeivalencia","itenergia",7,0,0,7,2021-11-26
"Equiplast","accio_cat",7,0,0,7,2021-11-26
"Eurosurfas","IREC_Energia",7,0,0,7,2021-11-26
"HABRILAN","aimplas",7,0,0,7,2021-11-26
"iambiente","aimplas",7,0,0,7,2021-11-26
"infoagrocom","aimplas",7,0,0,7,2021-11-26
"MaripeSamper","aimplas",7,0,0,7,2021-11-26
"OCRValencia","palbeme",7,0,0,7,2021-11-26
"OCRValencia","Redit_es",7,0,0,7,2021-11-26
"OVTT","aimplas",7,0,0,7,2021-11-26
"parccientificuv","aimplas",7,0,0,7,2021-11-26
"RSM_es","aimplas",7,0,0,7,2021-11-26
"SusChemSpain","BASF_ES",7,0,0,7,2021-11-26
"SusChemSpain","Repsol",7,0,0,7,2021-11-26
"SusChemSpain","SABIC",7,0,0,7,2021-11-26
"UPLIFT_EU","MixUp_H2020",7,0,0,7,2021-11-26
"WaystupH2020","GVAivia",7,0,0,7,2021-11-26
"WaystupH2020","UA_Universidad",7,0,0,7,2021-11-26
"_asobiocom","CENER_Energia",6,0,0,6,2021-11-26
"aec_es","aec_es",1,0,5,6,2021-11-26
"AEMAC_","ImdeaMaterials",6,0,0,6,2021-11-26
"AErasmusproject","aimplas",6,0,0,6,2021-11-26
"ait_research","AIT__LIT",6,0,0,6,2021-11-26
"Asefapi_Es","aimplas",6,0,0,6,2021-11-26
"CdeCarnica","ainiatecnologia",6,0,0,6,2021-11-26
"ceeivalencia","CDTIoficial",6,0,0,6,2021-11-26
"ceeivalencia","GVAeconomia",6,0,0,6,2021-11-26
"ClusterMAV","aimplas",6,0,0,6,2021-11-26
"Corresponsables","aimplas",6,0,0,6,2021-11-26
"CTplasUy","aimplas",6,0,0,6,2021-11-26
"DGreenblogger","aimplas",6,0,0,6,2021-11-26
"Equiplast","Cicloplast_com",6,0,0,6,2021-11-26
"Equiplast","IREC_Energia",6,0,0,6,2021-11-26
"escamilla50","GVAeconomia",3,0,3,6,2021-11-26
"escamilla50","skrollerbelt",4,0,2,6,2021-11-26
"expoquimia","Eurecat_news",6,0,0,6,2021-11-26
"FuturEnviro","ainiatecnologia",6,0,0,6,2021-11-26
"FuturEnviro","Cicloplast_com",6,0,0,6,2021-11-26
"FuturEnviro","GVAavi",6,0,0,6,2021-11-26
"iambiente","ainiatecnologia",6,0,0,6,2021-11-26
"ibv_org","GVAivace",6,0,0,6,2021-11-26
"itenergia","itenergia",6,0,0,6,2021-11-26
"mafehegu","aimplas",3,0,3,6,2021-11-26
"MaripeSamper","Grupo_TSK",6,0,0,6,2021-11-26
"MaripeSamper","Molecor",6,0,0,6,2021-11-26
"MaripeSamper","PigCHAMP_Europa",6,0,0,6,2021-11-26
"MaripeSamper","PlatinoEduca",6,0,0,6,2021-11-26
"Mateprincs","aimplas",6,0,0,6,2021-11-26
"OEPM_es","aimplas",6,0,0,6,2021-11-26
"PlasticsEuropES","ANAIP_es",6,0,0,6,2021-11-26
"PlasticsEuropES","ANARPLA",6,0,0,6,2021-11-26
"PlasticsEuropES","Cicloplast_com",6,0,0,6,2021-11-26
"Redit_es","OCRValencia",6,0,0,6,2021-11-26
"revista_PQ","aimplas",5,0,1,6,2021-11-26
"RevistaRETEMA","ecodes",6,0,0,6,2021-11-26
"RevistaRETEMA","INTE_UPC",6,0,0,6,2021-11-26
"RSM_es","ainiatecnologia",6,0,0,6,2021-11-26
"UPLIFT_EU","H2020demeto",6,0,0,6,2021-11-26
"Vertidos_Cero","uvigo",6,0,0,6,2021-11-26
"WaystupH2020","Biopolis_SL",6,0,0,6,2021-11-26
"WaystupH2020","BioSenseRS",6,0,0,6,2021-11-26
"WaystupH2020","fCIRCE",6,0,0,6,2021-11-26
"WaystupH2020","Novamont",6,0,0,6,2021-11-26
"WaystupH2020","SAV_lavega",6,0,0,6,2021-11-26
"WaystupH2020","Terra_i_Xufa",6,0,0,6,2021-11-26
"aec_es","AEDIVE",5,0,0,5,2021-11-26
"AEMAC_","amade_udg",5,0,0,5,2021-11-26
"AEMAC_","ferrerdalmaucm",5,0,0,5,2021-11-26
"AEMAC_","industry_arena",3,0,2,5,2021-11-26
"AEMAC_","tecnalia",5,0,0,5,2021-11-26
"AErasmusproject","euhospitals",5,0,0,5,2021-11-26
"AErasmusproject","HIHIreland",5,0,0,5,2021-11-26
"AErasmusproject","IDIVALdireccion",5,0,0,5,2021-11-26
"AErasmusproject","Jobsatskills",5,0,0,5,2021-11-26
"Agrimax_EU","aimplas",5,0,0,5,2021-11-26
"AgroNewsCV","aimplas",5,0,0,5,2021-11-26
"ait_research","AthloneIT",3,2,0,5,2021-11-26
"ait_research","AvecomNV",5,0,0,5,2021-11-26
"Azmudeu","Azmudeu",5,0,0,5,2021-11-26
"BeonNAT_H2020","BTU_CS",5,0,0,5,2021-11-26
"BeonNAT_H2020","CederCiemat",5,0,0,5,2021-11-26
"BeonNAT_H2020","FCesefor",5,0,0,5,2021-11-26
"BeonNAT_H2020","PEFCSpain",5,0,0,5,2021-11-26
"cdcampo1","aimplas",5,0,0,5,2021-11-26
"ceeivalencia","Biopolis_SL",5,0,0,5,2021-11-26
"ceeivalencia","GVAivace",5,0,0,5,2021-11-26
"ceeivalencia","iata_csic",5,0,0,5,2021-11-26
"ceeivalencia","Redit_es",5,0,0,5,2021-11-26
"ceeivalencia","seimedcv",5,0,0,5,2021-11-26
"disruptores_inn","aimplas",5,0,0,5,2021-11-26
"ECOTOX2","Vertidos_Cero",3,0,2,5,2021-11-26
"EFE_CValenciana","aimplas",5,0,0,5,2021-11-26
"emprenemjunts","itenergia",5,0,0,5,2021-11-26
"Equiplast","Eurecat_news",5,0,0,5,2021-11-26
"escamilla50","aimplas",5,0,0,5,2021-11-26
"escamilla50","CentrosCex",5,0,0,5,2021-11-26
"escamilla50","GVAivace",5,0,0,5,2021-11-26
"escamilla50","Julia_company",5,0,0,5,2021-11-26
"escamilla50","Rafa_Climentg",5,0,0,5,2021-11-26
"Eurosurfas","Eurecat_news",5,0,0,5,2021-11-26
"Eurosurfas","Leitat",5,0,0,5,2021-11-26
"expoquimia","AEMAC_",5,0,0,5,2021-11-26
"FCalidad","aimplas",4,0,1,5,2021-11-26
"Fedit","Redit_es",5,0,0,5,2021-11-26
"FEVEC_Valencia","aimplas",5,0,0,5,2021-11-26
"ffe_es","materplat",4,0,1,5,2021-11-26
"FuturEnviro","Vertidos_Cero",5,0,0,5,2021-11-26
"GVAavi","GVAavi",5,0,0,5,2021-11-26
"GVAivace","CentrosCex",2,3,0,5,2021-11-26
"InterplastPT","aimplas",5,0,0,5,2021-11-26
"ITC_ceramica","GVAivace",5,0,0,5,2021-11-26
"ITI_TIC","aimplas",5,0,0,5,2021-11-26
"MaripeSamper","corifyAF",5,0,0,5,2021-11-26
"MartaEGMosquera","aimplas",5,0,0,5,2021-11-26
"MartaEGMosquera","inbiotecenlared",5,0,0,5,2021-11-26
"MartaEGMosquera","IQAR_UAH",5,0,0,5,2021-11-26
"MartaEGMosquera","UAHes",5,0,0,5,2021-11-26
"maytedomingo_","aimplas",5,0,0,5,2021-11-26
"maytedomingo_","ainiatecnologia",5,0,0,5,2021-11-26
"maytedomingo_","itenergia",5,0,0,5,2021-11-26
"maytedomingo_","ITI_TIC",5,0,0,5,2021-11-26
"maytedomingo_","Redit_es",5,0,0,5,2021-11-26
"Monviciano","EUGCC_cleanergy",3,0,2,5,2021-11-26
"Novamont_Iberia","aimplas",4,1,0,5,2021-11-26
"OCRValencia","Consum",5,0,0,5,2021-11-26
"OCRValencia","masapa1982",5,0,0,5,2021-11-26
"PackagingEurope","aimplas",5,0,0,5,2021-11-26
"parccientificuv","parccientificuv",0,0,5,5,2021-11-26
"plasticoshita","aimplas",4,0,1,5,2021-11-26
"PlasticsEuropES","AvepAsociacion",5,0,0,5,2021-11-26
"poscosecha","aimplas",5,0,0,5,2021-11-26
"pteco2","AgEInves",5,0,0,5,2021-11-26
"pteco2","incarCSIC",5,0,0,5,2021-11-26
"pteco2","tecnalia",5,0,0,5,2021-11-26
"pteco2","ualmeria",5,0,0,5,2021-11-26
"Regmurcialimpia","Ferfollos",3,0,2,5,2021-11-26
"RepetCoinnova","aimplas",4,1,0,5,2021-11-26
"RPM_Plasticos","ainiatecnologia",5,0,0,5,2021-11-26
"somoscidec","Afi_es",5,0,0,5,2021-11-26
"somoscidec","ainiatecnologia",5,0,0,5,2021-11-26
"somoscidec","fCIRCE",5,0,0,5,2021-11-26
"somoscidec","ICTA_UAB",5,0,0,5,2021-11-26
"ter4bithi4","aimplas",5,0,0,5,2021-11-26
"TRAKTECH_","aimplas",5,0,0,5,2021-11-26
"Vertidos_Cero","ArviInnovapesca",5,0,0,5,2021-11-26
"Vertidos_Cero","OceanetsProject",4,0,1,5,2021-11-26
"WaystupH2020","biobean",5,0,0,5,2021-11-26
"WaystupH2020","imec_int",5,0,0,5,2021-11-26
"WaystupH2020","NAFIGATECorp",5,0,0,5,2021-11-26
"WaystupH2020","ntua",5,0,0,5,2021-11-26
"WaystupH2020","SustainableCTgr",5,0,0,5,2021-11-26
"Wendy_Moreno_EU","ai_eic",3,0,2,5,2021-11-26
"10t_proyectos","aimplas",4,0,0,4,2021-11-26
"aalbaperez","Redit_es",2,1,1,4,2021-11-26
"AdonaiHM","javiergarciamar",3,0,1,4,2021-11-26
"AdonaiHM","Redit_es",3,1,0,4,2021-11-26
"aec_es","AENOR",4,0,0,4,2021-11-26
"aec_es","AnfacAutomovil",4,0,0,4,2021-11-26
"aec_es","BoschEspana",4,0,0,4,2021-11-26
"aec_es","DeutzBS",4,0,0,4,2021-11-26
"aec_es","QualityCpa",4,0,0,4,2021-11-26
"AEMAC_","AEMAC_",0,1,3,4,2021-11-26
"AEMAC_","aernnova_usa",4,0,0,4,2021-11-26
"AEMAC_","Airbus",4,0,0,4,2021-11-26
"AEMAC_","AirbusHeli",4,0,0,4,2021-11-26
"AEMAC_","CalpeIT",4,0,0,4,2021-11-26
"AEMAC_","CentrosCex",2,0,2,4,2021-11-26
"AEMAC_","expoquimia",3,1,0,4,2021-11-26
"AEMAC_","IDEKO_",4,0,0,4,2021-11-26
"AEMAC_","TalgoGroup",4,0,0,4,2021-11-26
"AEMAC_","tsisl_oficial",4,0,0,4,2021-11-26
"AErasmusproject","AMRCtraining",4,0,0,4,2021-11-26
"AErasmusproject","Itemas",4,0,0,4,2021-11-26
"AErasmusproject","NUIGinnovation",4,0,0,4,2021-11-26
"AErasmusproject","sheffielduni",4,0,0,4,2021-11-26
"AgoraScience","aimplas",4,0,0,4,2021-11-26
"Agrimax_EU","BBI2020",4,0,0,4,2021-11-26
"Agrimax_EU","biconsortium",4,0,0,4,2021-11-26
"Agrimax_EU","EU_H2020",4,0,0,4,2021-11-26
"AgroNewsCV","ainiatecnologia",4,0,0,4,2021-11-26
"ai_eic","AristosInfo",3,0,1,4,2021-11-26
"ai_eic","H2020_Partner",3,0,1,4,2021-11-26
"ai_eic","Wendy_Moreno_EU",3,0,1,4,2021-11-26
"AIJU_Tecnologi","aimplas",4,0,0,4,2021-11-26
"aimplas","PackEuropeEli",2,0,2,4,2021-11-26
"aimplas","SustainableInnE",2,0,2,4,2021-11-26
"andresgilnogues","PlasticFV",2,1,1,4,2021-11-26
"AseTUB","aimplas",3,1,0,4,2021-11-26
"asociacionruvid","aimplas",4,0,0,4,2021-11-26
"Benihort","Benihort",2,0,2,4,2021-11-26
"BeonNAT_H2020","ContacticaInnov",4,0,0,4,2021-11-26
"BeonNAT_H2020","Envirohemp",4,0,0,4,2021-11-26
"BeonNAT_H2020","LeibnizATB",4,0,0,4,2021-11-26
"BeonNAT_H2020","NNFCC",4,0,0,4,2021-11-26
"BeonNAT_H2020","recordbioenergy",4,0,0,4,2021-11-26
"BIOVAL_es","ceeivalencia",4,0,0,4,2021-11-26
"BIOVAL_es","GVAivace",4,0,0,4,2021-11-26
"BIOVAL_es","itene",4,0,0,4,2021-11-26
"BIOVAL_es","itenergia",4,0,0,4,2021-11-26
"BIOVAL_es","Redit_es",4,0,0,4,2021-11-26
"BIOVAL_es","seimedcv",4,0,0,4,2021-11-26
"botellas_eco","ResiduosPro",2,0,2,4,2021-11-26
"Cajamar","CticCita",4,0,0,4,2021-11-26
"cdcampo1","CentrosCex",2,0,2,4,2021-11-26
"ceeivalencia","ceeivalencia",3,0,1,4,2021-11-26
"ceeivalencia","emprenemjunts",4,0,0,4,2021-11-26
"ClusterFPrint","aimplas",4,0,0,4,2021-11-26
"ClusterFPrint","PT3NEO",4,0,0,4,2021-11-26
"Consalud_es","aimplas",4,0,0,4,2021-11-26
"DominoPrint_ES","aimplas",4,0,0,4,2021-11-26
"DominoPrint_ES","RPM_Plasticos",2,0,2,4,2021-11-26
"Economia_3","aimplas",4,0,0,4,2021-11-26
"EcoxyProject","aimplas",3,0,1,4,2021-11-26
"elEconomistaCV","aimplas",4,0,0,4,2021-11-26
"emprenemjunts","BIOVAL_es",4,0,0,4,2021-11-26
"emprenemjunts","Cicloplast_com",4,0,0,4,2021-11-26
"Equiplast","AEMAC_",4,0,0,4,2021-11-26
"Equiplast","ANAIP_es",4,0,0,4,2021-11-26
"Equiplast","PlasticsEuropES",4,0,0,4,2021-11-26
"Equiplast","tecnalia",4,0,0,4,2021-11-26
"esplasticos","Cicloplast_com",4,0,0,4,2021-11-26
"eurocarne","ainiatecnologia",4,0,0,4,2021-11-26
"Eurosurfas","AEMAC_",4,0,0,4,2021-11-26
"Eurosurfas","linknovate",4,0,0,4,2021-11-26
"Eurosurfas","RECOTRANS_H2020",4,0,0,4,2021-11-26
"expoquimia","FIDAMC_",4,0,0,4,2021-11-26
"Fernando_Ca_63","SagredoMarco",2,0,2,4,2021-11-26
"ffe_es","ffe_es",4,0,0,4,2021-11-26
"ForoQyS","esplasticos",2,2,0,4,2021-11-26
"ForoQyS","SusChemSpain",2,2,0,4,2021-11-26
"Fund_Diversidad","aimplas",3,0,1,4,2021-11-26
"FuturEnviro","Afi_es",4,0,0,4,2021-11-26
"FuturEnviro","fCIRCE",4,0,0,4,2021-11-26
"FuturEnviro","GVAivace",4,0,0,4,2021-11-26
"FuturEnviro","ICTA_UAB",4,0,0,4,2021-11-26
"FuturEnviro","IDAEA_CSIC",4,0,0,4,2021-11-26
"FuturEnviro","PaisajeLimpio",4,0,0,4,2021-11-26
"garcia_saludes","Redit_es",3,0,1,4,2021-11-26
"gbelenguer","aimplas",4,0,0,4,2021-11-26
"GeriatricArea","aimplas",4,0,0,4,2021-11-26
"GeriatricArea","ibv_org",4,0,0,4,2021-11-26
"GVAavi","IISLaFe",3,1,0,4,2021-11-26
"GVAivace","GVAivace",4,0,0,4,2021-11-26
"Hispackbcn","ainiatecnologia",4,0,0,4,2021-11-26
"IBIAE","IBIAE",2,0,2,4,2021-11-26
"industry_arena","3Dnatives_ES",4,0,0,4,2021-11-26
"industry_arena","Leitat",4,0,0,4,2021-11-26
"industry_arena","tecnalia",4,0,0,4,2021-11-26
"IndustryTalksES","aimplas",3,0,1,4,2021-11-26
"InforetailNews","aimplas",4,0,0,4,2021-11-26
"int_reciclaje","aimplas",4,0,0,4,2021-11-26
"ITC_ceramica","ainiatecnologia",4,0,0,4,2021-11-26
"ITC_ceramica","ITI_TIC",4,0,0,4,2021-11-26
"jhomstor","edpemo",2,0,2,4,2021-11-26
"KimitecGroup","aimplas",4,0,0,4,2021-11-26
"KimitecGroup","BBI2020",2,2,0,4,2021-11-26
"KNAUFINDSPAIN","aimplas",4,0,0,4,2021-11-26
"LosPackaging","aimplas",2,0,2,4,2021-11-26
"MadresXClimaCan","Regmurcialimpia",2,0,2,4,2021-11-26
"marijosidemaya","deborahciencia",2,0,2,4,2021-11-26
"MartaEGMosquera","geqo_rseq",4,0,0,4,2021-11-26
"maytedomingo_","AIDIMME",4,0,0,4,2021-11-26
"MPN_Magazine","aimplas",3,0,1,4,2021-11-26
"OanaCaro","deborahciencia",2,0,2,4,2021-11-26
"OC_Composites","HABRILAN",2,0,2,4,2021-11-26
"OleoRevista","aimplas",4,0,0,4,2021-11-26
"olgainfoedita","aimplas",2,0,2,4,2021-11-26
"OVTTenglish","aimplas",4,0,0,4,2021-11-26
"Packnet_","ainiatecnologia",4,0,0,4,2021-11-26
"Packnet_","Cicloplast_com",4,0,0,4,2021-11-26
"PilotHarbour","AutPortValencia",2,0,2,4,2021-11-26
"PlasticsEuropES","deborahciencia",3,1,0,4,2021-11-26
"pteco2","FunditecOrg",4,0,0,4,2021-11-26
"Redit_es","EU_H2020",4,0,0,4,2021-11-26
"Redit_es","palbeme",4,0,0,4,2021-11-26
"Regmurcialimpia","Afi_es",4,0,0,4,2021-11-26
"Regmurcialimpia","ainiatecnologia",4,0,0,4,2021-11-26
"Regmurcialimpia","fCIRCE",4,0,0,4,2021-11-26
"Regmurcialimpia","ICTA_UAB",4,0,0,4,2021-11-26
"Regmurcialimpia","IDAEA_CSIC",4,0,0,4,2021-11-26
"Regmurcialimpia","PaisajeLimpio",4,0,0,4,2021-11-26
"Regmurcialimpia","somoscidec",4,0,0,4,2021-11-26
"RevistaRETEMA","Cicloplast_com",4,0,0,4,2021-11-26
"SofiaRTD","aimplas",4,0,0,4,2021-11-26
"SOMM_alliance","ICTA_UAB",2,2,0,4,2021-11-26
"TeximInfo","ainiatecnologia",4,0,0,4,2021-11-26
"UPLIFT_EU","preserve_h2020",4,0,0,4,2021-11-26
"Vastuullisuus","aimplas",4,0,0,4,2021-11-26
"Vastuullisuus","Vastuullisuus",4,0,0,4,2021-11-26
"Vertidos_Cero","FBiodiversidad",4,0,0,4,2021-11-26
"Vesismin","aimplas",2,2,0,4,2021-11-26
"WaystupH2020","tuc_chania",4,0,0,4,2021-11-26
"3duardoFG","ter4bithi4",1,1,1,3,2021-11-26
"AbelardoDuran","aimplas",2,0,1,3,2021-11-26
"ADCV_com","Redit_es",2,0,1,3,2021-11-26
"aec_es","AECA_ITV",3,0,0,3,2021-11-26
"aec_es","AEI_Rioja_Auto",3,0,0,3,2021-11-26
"aec_es","ANAIP_es",3,0,0,3,2021-11-26
"aec_es","AutomotiveCie",3,0,0,3,2021-11-26
"aec_es","CAARAUTOARAGON",3,0,0,3,2021-11-26
"aec_es","cluster_facyl",3,0,0,3,2021-11-26
"aec_es","EurofirmsGroup",3,0,0,3,2021-11-26
"aec_es","Fundacion_FUNME",3,0,0,3,2021-11-26
"aec_es","gestamp_es",3,0,0,3,2021-11-26
"aec_es","MBenzEspana",3,0,0,3,2021-11-26
"aec_es","sernauto",3,0,0,3,2021-11-26
"aec_es","TessiGroupe_es",3,0,0,3,2021-11-26
"aec_es","TRIGO_TQN",3,0,0,3,2021-11-26
"AEMAC_","aimenct",3,0,0,3,2021-11-26
"AEMAC_","Applynano",3,0,0,3,2021-11-26
"AEMAC_","CDTIoficial",3,0,0,3,2021-11-26
"AEMAC_","CIDETEC_",3,0,0,3,2021-11-26
"AEMAC_","cimne",3,0,0,3,2021-11-26
"AEMAC_","Equiplast",3,0,0,3,2021-11-26
"AEMAC_","FagorAutomation",3,0,0,3,2021-11-26
"AEMAC_","HexcelCorp",3,0,0,3,2021-11-26
"AEMAC_","ictp_promocion",3,0,0,3,2021-11-26
"AEMAC_","IKERLANofficial",3,0,0,3,2021-11-26
"AEMAC_","Titania_aero",3,0,0,3,2021-11-26
"AEMAC_","ZiurComposites",3,0,0,3,2021-11-26
"AgoraScience","tecnalia",3,0,0,3,2021-11-26
"agrochemie","UPLIFT_EU",3,0,0,3,2021-11-26
"ai_eic","accio_cat",3,0,0,3,2021-11-26
"ai_eic","aimplas",3,0,0,3,2021-11-26
"ai_eic","biocat_cat",3,0,0,3,2021-11-26
"ai_eic","CDTIoficial",3,0,0,3,2021-11-26
"ai_eic","eencat",3,0,0,3,2021-11-26
"ai_eic","Eurecat_news",3,0,0,3,2021-11-26
"ai_eic","horizonexperts",3,0,0,3,2021-11-26
"ai_eic","IreneLarroy",3,0,0,3,2021-11-26
"ai_eic","itene",3,0,0,3,2021-11-26
"ai_eic","JCGarcia_CDTI",3,0,0,3,2021-11-26
"ai_eic","jordipietx",3,0,0,3,2021-11-26
"ai_eic","RosaAriasAlv",3,0,0,3,2021-11-26
"ai_eic","scibus",3,0,0,3,2021-11-26
"ai_eic","SorosGabinete",3,0,0,3,2021-11-26
"ai_eic","talk2much12",3,0,0,3,2021-11-26
"aimplas","InescopTech",3,0,0,3,2021-11-26
"ainiatecnologia","Nestle_es",3,0,0,3,2021-11-26
"ainiatecnologia","Tecnifood",3,0,0,3,2021-11-26
"ait_research","BioICEP_H2020",3,0,0,3,2021-11-26
"ait_research","SergioFCeballos",2,1,0,3,2021-11-26
"Alvaro_Eslu","GVAivace",3,0,0,3,2021-11-26
"ANAIP_es","BASF_ES",3,0,0,3,2021-11-26
"ANAIP_es","Repsol",3,0,0,3,2021-11-26
"anape_eps","aimplas",3,0,0,3,2021-11-26
"anape_eps","Cicloplast_com",3,0,0,3,2021-11-26
"AperitivoSnacks","aimplas",3,0,0,3,2021-11-26
"AsocEyC","aimplas",3,0,0,3,2021-11-26
"AtfProfessional","aimplas",3,0,0,3,2021-11-26
"AutPortValencia","aimplas",3,0,0,3,2021-11-26
"Avia_automocion","aimplas",3,0,0,3,2021-11-26
"Baliht_EU","aimplas",3,0,0,3,2021-11-26
"BeonNAT_H2020","BBI2020",3,0,0,3,2021-11-26
"BeonNAT_H2020","BeonNAT_H2020",0,0,3,3,2021-11-26
"BeonNAT_H2020","USVro",3,0,0,3,2021-11-26
"BIOnTop_Project","aimplas",3,0,0,3,2021-11-26
"BIOnTop_Project","BIOnTop_Project",3,0,0,3,2021-11-26
"BIOVAL_es","ainiatecnologia",3,0,0,3,2021-11-26
"BIOVAL_es","CDTIoficial",3,0,0,3,2021-11-26
"BIOVAL_es","InescopTech",3,0,0,3,2021-11-26
"Cajamar","aimplas",3,0,0,3,2021-11-26
"cdcampo1","Redit_es",2,0,1,3,2021-11-26
"ceeivalencia","ceei",3,0,0,3,2021-11-26
"Club_Excelencia","aimplas",3,0,0,3,2021-11-26
"ClusterFPrint","fenin_es",3,0,0,3,2021-11-26
"ClusterFPrint","NanomedSpain",3,0,0,3,2021-11-26
"COGITIValencia","aimplas",3,0,0,3,2021-11-26
"ColegioSalliver","Club_Excelencia",2,0,1,3,2021-11-26
"ColegioSalliver","GrupoSorollaEdu",2,0,1,3,2021-11-26
"compromisoclima","aimplas",2,0,1,3,2021-11-26
"CTplasUy","CTplasUy",2,1,0,3,2021-11-26
"ECAndalucia","aimplas",3,0,0,3,2021-11-26
"emprenemjunts","ainiatecnologia",3,0,0,3,2021-11-26
"Equiplast","FIDAMC_",3,0,0,3,2021-11-26
"Equiplast","harvestoreEU",3,0,0,3,2021-11-26
"Equiplast","ICIQchem",3,0,0,3,2021-11-26
"Equiplast","la_UPC",3,0,0,3,2021-11-26
"Equiplast","linknovate",3,0,0,3,2021-11-26
"Equiplast","RECOTRANS_H2020",3,0,0,3,2021-11-26
"escamilla50","JoseVilar3",3,0,0,3,2021-11-26
"escamilla50","RebecaOntinyent",3,0,0,3,2021-11-26
"escamilla50","Redit_es",3,0,0,3,2021-11-26
"escamilla50","Sebastia_Jordi",3,0,0,3,2021-11-26
"EUBioplastics","aimplas",3,0,0,3,2021-11-26
"Eurosurfas","FIDAMC_",3,0,0,3,2021-11-26
"Eurosurfas","harvestoreEU",3,0,0,3,2021-11-26
"Eurosurfas","ICIQchem",3,0,0,3,2021-11-26
"Eurosurfas","la_UPC",3,0,0,3,2021-11-26
"Fedit","InescopTech",3,0,0,3,2021-11-26
"Fedit","ITC_ceramica",3,0,0,3,2021-11-26
"feriaecofira","aimplas",3,0,0,3,2021-11-26
"ffe_es","aimplas",3,0,0,3,2021-11-26
"ffe_es","CIDETEC_",3,0,0,3,2021-11-26
"FlotantProject","aimplas",3,0,0,3,2021-11-26
"FlotantProject","plocan",3,0,0,3,2021-11-26
"FuturEnviro","ACCIONA",3,0,0,3,2021-11-26
"FuturEnviro","TOMRARecycling",3,0,0,3,2021-11-26
"gbelenguer","itenergia",3,0,0,3,2021-11-26
"gbelenguer","Redit_es",3,0,0,3,2021-11-26
"GoHubTech","aimplas",3,0,0,3,2021-11-26
"Grupo_Soledad","istobal_es",2,0,1,3,2021-11-26
"GVAavi","Benihort",3,0,0,3,2021-11-26
"GVAavi","Betelgeux_es",3,0,0,3,2021-11-26
"GVAavi","IBMCP",3,0,0,3,2021-11-26
"GVAavi","ITC_Packaging",3,0,0,3,2021-11-26
"GVAavi","ITQ_UPVCSIC",3,0,0,3,2021-11-26
"GVAavi","UPV",3,0,0,3,2021-11-26
"GVAavi","UV_EG",3,0,0,3,2021-11-26
"GVAivace","AIDIMME",3,0,0,3,2021-11-26
"HABRILAN","AdvanFactories",2,0,1,3,2021-11-26
"HABRILAN","FIDAMC_",3,0,0,3,2021-11-26
"HABRILAN","OC_Composites",2,0,1,3,2021-11-26
"HABRILAN","Redit_es",3,0,0,3,2021-11-26
"i_alimentacion","aimplas",3,0,0,3,2021-11-26
"IBIAE","aimplas",3,0,0,3,2021-11-26
"ibv_org","HGUVALENCIA",3,0,0,3,2021-11-26
"ibv_org","ibv_org",3,0,0,3,2021-11-26
"ibv_org","IRTIC_UV",3,0,0,3,2021-11-26
"IDG_tv","UNESID",2,0,1,3,2021-11-26
"iiama_upv","aimplas",3,0,0,3,2021-11-26
"iiama_upv","GlobalOmnium",3,0,0,3,2021-11-26
"iiama_upv","Grupo_CALAGUA",3,0,0,3,2021-11-26
"industry_arena","AEMAC_",3,0,0,3,2021-11-26
"industry_arena","ENCS_CyberSec",3,0,0,3,2021-11-26
"industry_arena","Eurecat_news",3,0,0,3,2021-11-26
"industry_arena","festo_global",3,0,0,3,2021-11-26
"industry_arena","HispaRob",3,0,0,3,2021-11-26
"industry_arena","HP",3,0,0,3,2021-11-26
"industry_arena","IAM3DHUB",3,0,0,3,2021-11-26
"industry_arena","interempresas",3,0,0,3,2021-11-26
"industry_arena","MundoEmpresas",3,0,0,3,2021-11-26
"industry_arena","NAutomatizacion",3,0,0,3,2021-11-26
"industry_arena","SECARTYS",3,0,0,3,2021-11-26
"IndustryTalksES","IndustryTalksES",3,0,0,3,2021-11-26
"innotransfer","aimplas",3,0,0,3,2021-11-26
"innotransfer","espaitec",3,0,0,3,2021-11-26
"int_automocio","aimplas",3,0,0,3,2021-11-26
"ItalyFoodTrade","ecoefishent",2,0,1,3,2021-11-26
"ITC_ceramica","AIJU_Tecnologi",3,0,0,3,2021-11-26
"ITC_ceramica","aitex_es",3,0,0,3,2021-11-26
"ITC_ceramica","ibv_org",3,0,0,3,2021-11-26
"ITC_ceramica","InescopTech",3,0,0,3,2021-11-26
"ITC_ceramica","itene",3,0,0,3,2021-11-26
"ITC_ceramica","itenergia",3,0,0,3,2021-11-26
"izarotech","ANARPLA",3,0,0,3,2021-11-26
"izarotech","Cicloplast_com",3,0,0,3,2021-11-26
"izarotech","GVAivace",3,0,0,3,2021-11-26
"jealvarez","aimplas",3,0,0,3,2021-11-26
"JECComposites","aimplas",3,0,0,3,2021-11-26
"MartaEGMosquera","lualnu10",2,1,0,3,2021-11-26
"Mateprincs","Mateprincs",1,0,2,3,2021-11-26
"materplat","ffe_es",2,0,1,3,2021-11-26
"maytedomingo_","ibv_org",3,0,0,3,2021-11-26
"maytedomingo_","ITC_ceramica",3,0,0,3,2021-11-26
"maytedomingo_","itene",3,0,0,3,2021-11-26
"maytedomingo_","valenciaplaza",3,0,0,3,2021-11-26
"MetalMadridEs","aimplas",3,0,0,3,2021-11-26
"Monviciano","aimplas",3,0,0,3,2021-11-26
"NagrifoodClust","aimplas",3,0,0,3,2021-11-26
"NagrifoodClust","itene",3,0,0,3,2021-11-26
"NagrifoodClust","unav",3,0,0,3,2021-11-26
"NagrifoodClust","UNavarra",3,0,0,3,2021-11-26
"NagrifoodClust","Zabala_IC",3,0,0,3,2021-11-26
"NontoxProject","NontoxProject",2,0,1,3,2021-11-26
"OceanetsProject","ArviInnovapesca",3,0,0,3,2021-11-26
"OceanetsProject","ecoalf",3,0,0,3,2021-11-26
"OceanetsProject","EU_MARE",3,0,0,3,2021-11-26
"OceanetsProject","Vertidos_Cero",3,0,0,3,2021-11-26
"Packnet_","Alimarket",3,0,0,3,2021-11-26
"Packnet_","EssentraPackES",3,0,0,3,2021-11-26
"Packnet_","Food4LifeSPAIN",3,0,0,3,2021-11-26
"Packnet_","Sealed_Air",3,0,0,3,2021-11-26
"Packnet_","UABBarcelona",3,0,0,3,2021-11-26
"pharmamarket","IISLaFe",3,0,0,3,2021-11-26
"Plastico_Indl","aimplas",3,0,0,3,2021-11-26
"PlasticsEuropES","BASF_ES",3,0,0,3,2021-11-26
"PlasticsEuropES","Repsol",3,0,0,3,2021-11-26
"PlasticsEuropES","SABIC",3,0,0,3,2021-11-26
"poscosecha","ainiatecnologia",3,0,0,3,2021-11-26
"preserve_h2020","aimplas",2,1,0,3,2021-11-26
"pteco2","pteco2",1,2,0,3,2021-11-26
"recosol_pr","aimplas",3,0,0,3,2021-11-26
"Redit_es","masapa1982",3,0,0,3,2021-11-26
"Redit_es","valenciaplaza",3,0,0,3,2021-11-26
"Regmurcialimpia","AEMArm",3,0,0,3,2021-11-26
"REMADYL_EU","EU_EASME",2,0,1,3,2021-11-26
"revistaide","Cicloplast_com",3,0,0,3,2021-11-26
"revistaimcb","aimplas",2,0,1,3,2021-11-26
"RevistaMercados","ainiatecnologia",3,0,0,3,2021-11-26
"RevistaOlimerca","aimplas",2,0,1,3,2021-11-26
"SagredoMarco","entidadPTV",3,0,0,3,2021-11-26
"SanchisFederico","aimplas",3,0,0,3,2021-11-26
"somoscidec","PaisajeLimpio",3,0,0,3,2021-11-26
"SusanaPBadal","MAmbienteBP_UJI",2,0,1,3,2021-11-26
"SusChemSpain","PlasticsEuropES",3,0,0,3,2021-11-26
"SustainPlastics","TNO_Research",3,0,0,3,2021-11-26
"Tecnifood","AvepAsociacion",3,0,0,3,2021-11-26
"Tecnifood","GVAavi",3,0,0,3,2021-11-26
"ter4bithi4","ANAIP_es",3,0,0,3,2021-11-26
"ter4bithi4","Cicloplast_com",3,0,0,3,2021-11-26
"ter4bithi4","esplasticos",3,0,0,3,2021-11-26
"ter4bithi4","PlasticsEuropES",3,0,0,3,2021-11-26
"veredictas","alzamoragroup",3,0,0,3,2021-11-26
"veredictas","Crisiscreativa",3,0,0,3,2021-11-26
"veredictas","irubistudio",3,0,0,3,2021-11-26
"Vertidos_Cero","ECOTOX2",2,0,1,3,2021-11-26
"WaystupH2020","BIOCAR_CIEMAT",3,0,0,3,2021-11-26
"WaystupH2020","DraxisEnv",3,0,0,3,2021-11-26
"WaystupH2020","WaystupH2020",3,0,0,3,2021-11-26
"WomenInPlastic","aimplas",3,0,0,3,2021-11-26
"3Recycler","RevistaAlimenta",1,0,1,2,2021-11-26
"88Harleen","aimplas",1,0,1,2,2021-11-26
"aalbaperez","AIJU_Tecnologi",2,0,0,2,2021-11-26
"aalbaperez","aimplas",2,0,0,2,2021-11-26
"aalbaperez","ainiatecnologia",2,0,0,2,2021-11-26
"aalbaperez","aitex_es",2,0,0,2,2021-11-26
"aalbaperez","ibv_org",2,0,0,2,2021-11-26
"aalbaperez","InescopTech",2,0,0,2,2021-11-26
"aalbaperez","ITC_ceramica",2,0,0,2,2021-11-26
"aalbaperez","itene",2,0,0,2,2021-11-26
"aalbaperez","ITI_TIC",2,0,0,2,2021-11-26
"AbelardoDuran","AbelardoDuran",0,2,0,2,2021-11-26
"acanocoloma","skrollerbelt",1,0,1,2,2021-11-26
"actualidadaero","aimplas",1,0,1,2,2021-11-26
"AdonaiHM","AIDIMME",2,0,0,2,2021-11-26
"AdonaiHM","AIJU_Tecnologi",2,0,0,2,2021-11-26
"AdonaiHM","aimplas",2,0,0,2,2021-11-26
"AdonaiHM","ainiatecnologia",2,0,0,2,2021-11-26
"AdonaiHM","aitex_es",2,0,0,2,2021-11-26
"AdonaiHM","Fedit",2,0,0,2,2021-11-26
"AdonaiHM","InescopTech",2,0,0,2,2021-11-26
"AdonaiHM","itenergia",2,0,0,2,2021-11-26
"AdvanFactories","aimplas",2,0,0,2,2021-11-26
"aec_es","AIN_Navarra",2,0,0,2,2021-11-26
"aec_es","Antolin_Oficial",2,0,0,2,2021-11-26
"aec_es","FCalidad",2,0,0,2,2021-11-26
"aec_es","GanvamOficial",2,0,0,2,2021-11-26
"aec_es","Gonvarri",2,0,0,2,2021-11-26
"aec_es","PolyWorks",2,0,0,2,2021-11-26
"AEMAC_","3Dnatives_ES",2,0,0,2,2021-11-26
"AEMAC_","AEBALL_UPMBALL",2,0,0,2,2021-11-26
"AEMAC_","AerAutomation",2,0,0,2,2021-11-26
"AEMAC_","aiasasociacion",2,0,0,2,2021-11-26
"AEMAC_","CEPplast",2,0,0,2,2021-11-26
"AEMAC_","CIDESIMX",2,0,0,2,2021-11-26
"AEMAC_","ClusterCICAT",2,0,0,2,2021-11-26
"AEMAC_","DANOBATGROUP",2,0,0,2,2021-11-26
"AEMAC_","DanobatSheetMet",2,0,0,2,2021-11-26
"AEMAC_","Eurosurfas",2,0,0,2,2021-11-26
"AEMAC_","GAIKER_BRTA",2,0,0,2,2021-11-26
"AEMAC_","GrupoOlmar",2,0,0,2,2021-11-26
"AEMAC_","HispaRob",2,0,0,2,2021-11-26
"AEMAC_","innovallcluster",2,0,0,2,2021-11-26
"AEMAC_","int_aeronautica",1,1,0,2,2021-11-26
"AEMAC_","mincoturgob",2,0,0,2,2021-11-26
"AEMAC_","OceanetsProject",2,0,0,2,2021-11-26
"AEMAC_","RECOTRANS_H2020",1,0,1,2,2021-11-26
"AEMAC_","SECARTYS",2,0,0,2,2021-11-26
"AEMAC_","testia",2,0,0,2,2021-11-26
"AEMAC_","tknika",2,0,0,2,2021-11-26
"AEMAC_","upvehu",2,0,0,2,2021-11-26
"AEMAC_","urjc",2,0,0,2,2021-11-26
"AErasmusproject","eu_tender",2,0,0,2,2021-11-26
"AErasmusproject","NUIGalwayMed",2,0,0,2,2021-11-26
"agapi_comunica","PlatinoEduca",1,0,1,2,2021-11-26
"AgoraScience","ANARPLA",1,0,1,2,2021-11-26
"AgoraScience","Cicloplast_com",2,0,0,2,2021-11-26
"AgoraScience","DaleVida_Plaas",1,1,0,2,2021-11-26
"AgoraScience","Leitat",2,0,0,2,2021-11-26
"agrochemie","acibGmbH",2,0,0,2,2021-11-26
"agrochemie","aimplas",2,0,0,2,2021-11-26
"agrochemie","Bioplastech",2,0,0,2,2021-11-26
"agrochemie","EU_H2020",2,0,0,2,2021-11-26
"agrochemie","fz_juelich",2,0,0,2,2021-11-26
"agrochemie","LeibnizHKI",2,0,0,2,2021-11-26
"agrochemie","RWTH",2,0,0,2,2021-11-26
"agrochemie","SustainableInnE",2,0,0,2,2021-11-26
"agrochemie","TECNARO_GmbH",2,0,0,2,2021-11-26
"agrochemie","ucddublin",2,0,0,2,2021-11-26
"AIJU_Tecnologi","GVAlabora",2,0,0,2,2021-11-26
"AIJU_Tecnologi","manudbto",1,0,1,2,2021-11-26
"AIJU_Tecnologi","RachelRock2",1,0,1,2,2021-11-26
"AIJU_Tecnologi","Redit_es",1,0,1,2,2021-11-26
"aimplas","3Dnatives_ES",2,0,0,2,2021-11-26
"aimplas","aec_es",2,0,0,2,2021-11-26
"aimplas","esplasticos",1,0,1,2,2021-11-26
"aimplas","GVAivace",2,0,0,2,2021-11-26
"aimplas","IndustrialesCV",1,0,1,2,2021-11-26
"aimplas","PackagingEurope",2,0,0,2,2021-11-26
"aimplas","ReportsMarkets",2,0,0,2,2021-11-26
"aimplas","universitatURV",2,0,0,2,2021-11-26
"aimplas","UPV",1,0,1,2,2021-11-26
"aimplas","urjc",2,0,0,2,2021-11-26
"ainiatecnologia","ANAIP_es",2,0,0,2,2021-11-26
"ainiatecnologia","ANARPLA",2,0,0,2,2021-11-26
"ainiatecnologia","iambiente",2,0,0,2,2021-11-26
"AIPIAcongress","3dclickclick",2,0,0,2,2021-11-26
"AIPIAcongress","AbbottGlobal",2,0,0,2,2021-11-26
"AIPIAcongress","Abigail__Dixon",2,0,0,2,2021-11-26
"AIPIAcongress","Accenture",2,0,0,2,2021-11-26
"AIPIAcongress","Advanced_TT",2,0,0,2,2021-11-26
"AIPIAcongress","AgriFoodX",2,0,0,2,2021-11-26
"AIPIAcongress","aimplas",2,0,0,2,2021-11-26
"ait_research","BioengPT",2,0,0,2,2021-11-26
"ait_research","chemengntua",2,0,0,2,2021-11-26
"ait_research","EU_Commission",2,0,0,2,2021-11-26
"ait_research","LimerickIT",2,0,0,2,2021-11-26
"ait_research","MRI_AthloneIT",2,0,0,2,2021-11-26
"ait_research","tcddublin",2,0,0,2,2021-11-26
"ALBAsynchrotron","khaqanshati",1,0,1,2,2021-11-26
"alcaide_mkt","PactoMundial",1,0,1,2,2021-11-26
"Alvaro_Eslu","ainiatecnologia",2,0,0,2,2021-11-26
"Alvaro_Eslu","CDTIoficial",2,0,0,2,2021-11-26
"Alvaro_Eslu","GVAavi",2,0,0,2,2021-11-26
"Alvaro_Eslu","IDAEA_CSIC",2,0,0,2,2021-11-26
"Alvaro_Eslu","ITC_ceramica",1,0,1,2,2021-11-26
"Alvaro_Eslu","mincoturgob",2,0,0,2,2021-11-26
"Alvaro_Eslu","sost_cdti",2,0,0,2,2021-11-26
"Amgarve","aimplas",1,0,1,2,2021-11-26
"anacanoarribas","Benihort",2,0,0,2,2021-11-26
"anacanoarribas","IBMCP",2,0,0,2,2021-11-26
"ANAIP_es","_asobiocom",1,0,1,2,2021-11-26
"ANAIP_es","CEIS_spain",2,0,0,2,2021-11-26
"ANAIP_es","Cicloplast_com",2,0,0,2,2021-11-26
"ANAIP_es","DANOSA_SPAIN",2,0,0,2,2021-11-26
"ANAIP_es","PlasticsEuropES",1,0,1,2,2021-11-26
"ANAIP_es","RecicladosLaRed",2,0,0,2,2021-11-26
"ANAIP_es","SABIC",2,0,0,2,2021-11-26
"anape_eps","esplasticos",1,0,1,2,2021-11-26
"AndreaCasoF","Redit_es",1,0,1,2,2021-11-26
"andresgilnogues","aimplas",2,0,0,2,2021-11-26
"andresgilnogues","AvepAsociacion",2,0,0,2,2021-11-26
"andresgilnogues","Feria_Valencia",2,0,0,2,2021-11-26
"ANIPAC_AC","aimplas",2,0,0,2,2021-11-26
"AnjanaLeon","CentrosCex",1,0,1,2,2021-11-26
"AnsiaDe","aimplas",2,0,0,2,2021-11-26
"AnsiaDe","ANAIP_es",1,0,1,2,2021-11-26
"AnsiaDe","asegre01",1,0,1,2,2021-11-26
"apk_ag","PlasticsEurope",1,1,0,2,2021-11-26
"apuntnoticies","aimplas",2,0,0,2,2021-11-26
"AristosInfo","ai_eic",1,0,1,2,2021-11-26
"Arturolarena","aimplas",2,0,0,2,2021-11-26
"Arturolarena","ainiatecnologia",2,0,0,2,2021-11-26
"Arturolarena","FGlobalNature",2,0,0,2,2021-11-26
"AseTUB","AseTUB",2,0,0,2,2021-11-26
"Asturicae","MartaEGMosquera",1,0,1,2,2021-11-26
"atmbiopro","UNLOCK_BBI",1,0,1,2,2021-11-26
"automatica_","aimplas",2,0,0,2,2021-11-26
"AVEmpresarios","garcia_saludes",2,0,0,2,2021-11-26
"AVEmpresarios","Redit_es",1,0,1,2,2021-11-26
"Baliht_EU","inea_eu",1,1,0,2,2021-11-26
"Bel21108685","aimplas",1,0,1,2,2021-11-26
"Benihort","aimplas",2,0,0,2,2021-11-26
"Benihort","IBMCP",2,0,0,2,2021-11-26
"BeonNAT_H2020","ipbraganca",2,0,0,2,2021-11-26
"Bio_Markets","BioSupPack_BBI",1,0,1,2,2021-11-26
"BIOnTop_Project","EUBioplastics",1,1,0,2,2021-11-26
"bioplasticsmag","aimplas",2,0,0,2,2021-11-26
"BioSenseRS","WaystupH2020",1,1,0,2,2021-11-26
"BiotechAndrew","aimplas",2,0,0,2,2021-11-26
"BIOVAL_es","AIDIMME",2,0,0,2,2021-11-26
"BIOVAL_es","Biopolis_SL",2,0,0,2,2021-11-26
"BIOVAL_es","BIOVAL_es",2,0,0,2,2021-11-26
"BIOVAL_es","DarwinBioprosp",2,0,0,2,2021-11-26
"BIOVAL_es","GVAeconomia",2,0,0,2,2021-11-26
"BIOVAL_es","iata_csic",2,0,0,2,2021-11-26
"BioVale_Cluster","Agrimax_EU",1,0,1,2,2021-11-26
"BlueMedEU","aimplas",2,0,0,2,2021-11-26
"BlueMedEU","azti_brta",2,0,0,2,2021-11-26
"BlueMedEU","BlueMedEU",0,0,2,2,2021-11-26
"BlueMedEU","CiimarUp",2,0,0,2,2021-11-26
"botellas_eco","aimplas",2,0,0,2,2021-11-26
"cabocla2001","Feique_ES",1,0,1,2,2021-11-26
"Cajamar","launioncorp",2,0,0,2,2021-11-26
"carlosgarcia_85","ainiatecnologia",1,1,0,2,2021-11-26
"cdcampo1","garcia_saludes",2,0,0,2,2021-11-26
"cdcampo1","gbelenguer",2,0,0,2,2021-11-26
"cdcampo1","OceanetsProject",2,0,0,2,2021-11-26
"CdeCarnica","sagrosus",2,0,0,2,2021-11-26
"CdeCarnica","Salvy_FoToLoSaL",1,0,1,2,2021-11-26
"CdeCarnica","vayavacacom",2,0,0,2,2021-11-26
"CDTIoficial","aimplas",2,0,0,2,2021-11-26
"ceeivalencia","AIDIMME",2,0,0,2,2021-11-26
"ceeivalencia","aitex_es",2,0,0,2,2021-11-26
"ceeivalencia","InescopTech",2,0,0,2,2021-11-26
"CEPplast","aimplas",2,0,0,2,2021-11-26
"CEPplast","industry_arena",1,0,1,2,2021-11-26
"CEPplast","veredictas",1,0,1,2,2021-11-26
"CetecCentro","ainiatecnologia",1,1,0,2,2021-11-26
"Cicloplast_com","ANARPLA",2,0,0,2,2021-11-26
"Cicloplast_com","AvepAsociacion",2,0,0,2,2021-11-26
"Cicloplast_com","Cicloplast_com",0,0,2,2,2021-11-26
"Cicloplast_com","esplasticos",0,2,0,2,2021-11-26
"Cicloplast_com","PlasticsEuropES",2,0,0,2,2021-11-26
"cinea_eu","aimplas",2,0,0,2,2021-11-26
"cinea_eu","OceanetsProject",2,0,0,2,2021-11-26
"CircolarMenteNS","aimplas",2,0,0,2,2021-11-26
"ClusterFPrint","Rev_Pressgraph",1,1,0,2,2021-11-26
"CNTA_CIT","aimplas",2,0,0,2,2021-11-26
"COEXPAN_","aimplas",2,0,0,2,2021-11-26
"ColegioSalliver","aimplas",2,0,0,2,2021-11-26
"CompositesSpain","aimplas",2,0,0,2,2021-11-26
"CompositesSpain","CompositesSpain",2,0,0,2,2021-11-26
"CompositesSpain","MetalMadridEs",2,0,0,2,2021-11-26
"CoopsAgroCV","aimplas",2,0,0,2,2021-11-26
"CosmeticLatam","aimplas",2,0,0,2,2021-11-26
"Crowdhelix","aimplas",2,0,0,2,2021-11-26
"CticCita","Cajamar",1,1,0,2,2021-11-26
"DarwinBioprosp","aimplas",2,0,0,2,2021-11-26
"Daype98","aimplas",2,0,0,2,2021-11-26
"deborahciencia","PilMontana",1,0,1,2,2021-11-26
"DGreenblogger","DGreenblogger",0,0,2,2,2021-11-26
"DGreenblogger","PERCAL_Project",2,0,0,2,2021-11-26
"DisenoCiudad","aimplas",2,0,0,2,2021-11-26
"disruptores_inn","Javarnau",2,0,0,2,2021-11-26
"disruptores_inn","UV_EG",2,0,0,2,2021-11-26
"DominoPrint_ES","Mundoplast",1,0,1,2,2021-11-26
"DominoPrint_ES","RevistaInfopack",1,0,1,2,2021-11-26
"DominoPrint_Mx","aimplas",1,0,1,2,2021-11-26
"DriadeSM","expoquimia",1,0,1,2,2021-11-26
"DriadeSM","gremirecupera",2,0,0,2,2021-11-26
"DriadeSM","LAB_Ecoinnova",2,0,0,2,2021-11-26
"DulcesNoticias","aimplas",2,0,0,2,2021-11-26
"EcoconstruMag","aimplas",2,0,0,2,2021-11-26
"ecoticiasRED","aimplas",2,0,0,2,2021-11-26
"ECOTOX2","aimplas",2,0,0,2,2021-11-26
"ECOTOX2","FBiodiversidad",2,0,0,2,2021-11-26
"ECOTOX2","FValenciaport",2,0,0,2,2021-11-26
"ECOTOX2","uvigo",2,0,0,2,2021-11-26
"EDICIONESSIBILA","AIDIMME",2,0,0,2,2021-11-26
"EDICIONESSIBILA","aimplas",2,0,0,2,2021-11-26
"EDICIONESSIBILA","InescopTech",2,0,0,2,2021-11-26
"edpemo","AgoraScience",1,0,1,2,2021-11-26
"EduTorregrosa12","skrollerbelt",1,0,1,2,2021-11-26
"EFEcomunica","aimplas",2,0,0,2,2021-11-26
"elEconomistaCV","Redit_es",2,0,0,2,2021-11-26
"elperiodic","Actecosl",2,0,0,2,2021-11-26
"elperiodic","aimplas",2,0,0,2,2021-11-26
"emprenemjunts","AIDIMME",2,0,0,2,2021-11-26
"emprenemjunts","aitex_es",2,0,0,2,2021-11-26
"emprenemjunts","GVAeconomia",2,0,0,2,2021-11-26
"emprenemjunts","GVAivace",2,0,0,2,2021-11-26
"emprenemjunts","InescopTech",2,0,0,2,2021-11-26
"emprenemjunts","Redit_es",2,0,0,2,2021-11-26
"emprenemjunts","UPV",2,0,0,2,2021-11-26
"entidadPTV","aimplas",2,0,0,2,2021-11-26
"Equiplast","amec_asoc",2,0,0,2,2021-11-26
"Erumgroup","aimplas",2,0,0,2,2021-11-26
"Erumgroup","GVAavi",2,0,0,2,2021-11-26
"escamilla50","ceeivalencia",2,0,0,2,2021-11-26
"escamilla50","generalitat",2,0,0,2,2021-11-26
"escamilla50","Startup_VLC",2,0,0,2,2021-11-26
"esplasticos","esplasticos",2,0,0,2,2021-11-26
"excedentesolar","BrigadistaR",1,0,1,2,2021-11-26
"FabricaPodcast","ITC_ceramica",1,0,1,2,2021-11-26
"Fedit","AIDIMME",2,0,0,2,2021-11-26
"Fedit","aiglesiasfraga",2,0,0,2,2021-11-26
"Fedit","CETEM_CT",2,0,0,2,2021-11-26
"Fedit","disruptores_inn",1,1,0,2,2021-11-26
"Fedit","Eurecat_news",2,0,0,2,2021-11-26
"Fedit","GVAivace",2,0,0,2,2021-11-26
"Ferfollos","Regmurcialimpia",1,0,1,2,2021-11-26
"Fernando_Ca_63","aimplas",2,0,0,2,2021-11-26
"FEVEC_Valencia","FEVEC_Valencia",2,0,0,2,2021-11-26
"ffe_es","CienciaGob",2,0,0,2,2021-11-26
"ffe_es","ImdeaMaterials",2,0,0,2,2021-11-26
"ffe_es","NavantiaOficial",2,0,0,2,2021-11-26
"fgirona","anacanoarribas",1,0,1,2,2021-11-26
"FGlobalis","aimplas",2,0,0,2,2021-11-26
"FIDAMC_","aimplas",2,0,0,2,2021-11-26
"fihguv","aimplas",2,0,0,2,2021-11-26
"fihguv","GVAavi",2,0,0,2,2021-11-26
"fihguv","ibv_org",2,0,0,2,2021-11-26
"financialfood","aimplas",1,0,1,2,2021-11-26
"FlotantProject","ITA_RWTHAachen",2,0,0,2,2021-11-26
"food_retail","aimplas",2,0,0,2,2021-11-26
"Food4LifeSPAIN","aimplas",2,0,0,2,2021-11-26
"Food4LifeSPAIN","Food4LifeSPAIN",2,0,0,2,2021-11-26
"Food4LifeSPAIN","Fuelium_",2,0,0,2,2021-11-26
"Food4LifeSPAIN","packcluster",2,0,0,2,2021-11-26
"ForoQyS","BASF_ES",2,0,0,2,2021-11-26
"ForoQyS","Cicloplast_com",2,0,0,2,2021-11-26
"ForoQyS","PlasticsEuropES",2,0,0,2,2021-11-26
"ForoQyS","Redit_es",1,1,0,2,2021-11-26
"ForoQyS","Repsol",2,0,0,2,2021-11-26
"ForoQyS","SABIC",2,0,0,2,2021-11-26
"Fryjole","CDTIoficial",1,0,1,2,2021-11-26
"Fryjole","EmbEspTurquia",2,0,0,2,2021-11-26
"FuturEnviro","Actecosl",2,0,0,2,2021-11-26
"FuturEnviro","ANARPLA",2,0,0,2,2021-11-26
"FuturEnviro","Benihort",2,0,0,2,2021-11-26
"FuturEnviro","CarmofProject",2,0,0,2,2021-11-26
"FuturEnviro","GlobalOmnium",2,0,0,2,2021-11-26
"FuturEnviro","IBMCP",2,0,0,2,2021-11-26
"FuturEnviro","TeknikerOficial",2,0,0,2,2021-11-26
"FuturEnviro","VeoliaWaterTech",2,0,0,2,2021-11-26
"GAIKER_BRTA","gaiker",1,0,1,2,2021-11-26
"GBDC78","Actuenviro",1,0,1,2,2021-11-26
"gbelenguer","AIDIMME",2,0,0,2,2021-11-26
"gbelenguer","AIJU_Tecnologi",2,0,0,2,2021-11-26
"gbelenguer","ainiatecnologia",2,0,0,2,2021-11-26
"gbelenguer","aitex_es",2,0,0,2,2021-11-26
"gbelenguer","cdcampo1",1,0,1,2,2021-11-26
"gbelenguer","esquerrapv",1,0,1,2,2021-11-26
"gbelenguer","Fedit",2,0,0,2,2021-11-26
"gbelenguer","GVAavi",2,0,0,2,2021-11-26
"gbelenguer","GVAinnova",2,0,0,2,2021-11-26
"gbelenguer","InescopTech",2,0,0,2,2021-11-26
"gbelenguer","ITC_ceramica",2,0,0,2,2021-11-26
"gbelenguer","javiergarciamar",1,0,1,2,2021-11-26
"gbelenguer","OCRValencia",2,0,0,2,2021-11-26
"GimenoGroup","MartaEGMosquera",1,0,1,2,2021-11-26
"GlobalOmnium","aimplas",2,0,0,2,2021-11-26
"GlobalOmnium","capasvil",2,0,0,2,2021-11-26
"GlobalOmnium","GlobalOmnium",2,0,0,2,2021-11-26
"GlobalOmnium","GVAavi",2,0,0,2,2021-11-26
"GlobalOmnium","GVAinnova",2,0,0,2,2021-11-26
"GlobalOmnium","UVa_es",2,0,0,2,2021-11-26
"GoHubTech","aganovagrupo",2,0,0,2,2021-11-26
"GoHubTech","EosOrbital",2,0,0,2,2021-11-26
"GoHubTech","GlobalOmnium",2,0,0,2,2021-11-26
"GoHubTech","lasprovincias",2,0,0,2,2021-11-26
"GoHubTech","LinkenerSpain",2,0,0,2,2021-11-26
"GRACE_BBI","Agrimax_EU",1,0,1,2,2021-11-26
"GrupoSorollaEdu","aimplas",2,0,0,2,2021-11-26
"GrupoSorollaEdu","Club_Excelencia",1,0,1,2,2021-11-26
"GrupoSorollaEdu","ColegioSalliver",2,0,0,2,2021-11-26
"GrupoTHM","aimplas",2,0,0,2,2021-11-26
"GVAavi","HospitalLaFe",2,0,0,2,2021-11-26
"GVAavi","idainature",1,1,0,2,2021-11-26
"GVAavi","UA_Universitat",2,0,0,2,2021-11-26
"GVAeconomia","aimplas",2,0,0,2,2021-11-26
"GVAeconomia","GVAivace",2,0,0,2,2021-11-26
"GVAeconomia","Rafa_Climentg",2,0,0,2,2021-11-26
"GVAinnova","aimplas",1,1,0,2,2021-11-26
"GVAivace","ainiatecnologia",2,0,0,2,2021-11-26
"GVAivace","InescopTech",2,0,0,2,2021-11-26
"GVAivace","itene",2,0,0,2,2021-11-26
"GVAivace","seimedcv",1,1,0,2,2021-11-26
"GVAivace","skrollerbelt",2,0,0,2,2021-11-26
"H2020_Partner","IreneLarroy",2,0,0,2,2021-11-26
"H2020_Partner","talk2much12",1,0,1,2,2021-11-26
"HABRILAN","aitex_es",2,0,0,2,2021-11-26
"HABRILAN","CDTIoficial",2,0,0,2,2021-11-26
"HABRILAN","CMplastik",2,0,0,2,2021-11-26
"HABRILAN","Colquimva",2,0,0,2,2021-11-26
"HABRILAN","Eurecat_news",2,0,0,2,2021-11-26
"HABRILAN","InescopTech",2,0,0,2,2021-11-26
"hasta_el_lunes","aimplas",2,0,0,2,2021-11-26
"hasta_el_lunes","reverdeconcausa",1,0,1,2,2021-11-26
"Hispackbcn","Hispackbcn",2,0,0,2,2021-11-26
"iambiente","Redit_es",2,0,0,2,2021-11-26
"IBMCP","aimplas",2,0,0,2,2021-11-26
"IBMCP","Benihort",2,0,0,2,2021-11-26
"IBMCP","IBMCP",2,0,0,2,2021-11-26
"IDG_tv","ADEMI_Informa",2,0,0,2,2021-11-26
"IDG_tv","AIDIMME",2,0,0,2,2021-11-26
"IDG_tv","aimplas",2,0,0,2,2021-11-26
"IDG_tv","ainiatecnologia",2,0,0,2,2021-11-26
"IDG_tv","CEPCO_es",2,0,0,2,2021-11-26
"IDG_tv","confemetal",2,0,0,2,2021-11-26
"IDG_tv","esFIAB",2,0,0,2,2021-11-26
"IDG_tv","FedeconModa",2,0,0,2,2021-11-26
"IDG_tv","Fedit",2,0,0,2,2021-11-26
"IDG_tv","itene",2,0,0,2,2021-11-26
"IDG_tv","sernauto",2,0,0,2,2021-11-26
"IDG_tv","SocEspCeramVidr",2,0,0,2,2021-11-26
"iiama_upv","GVAavi",2,0,0,2,2021-11-26
"impulsa_ciu","CTplasUy",1,1,0,2,2021-11-26
"InboplastMx","aimplas",1,0,1,2,2021-11-26
"industry_arena","AEBALL_UPMBALL",2,0,0,2,2021-11-26
"industry_arena","AerAutomation",2,0,0,2,2021-11-26
"industry_arena","aiasasociacion",2,0,0,2,2021-11-26
"industry_arena","CEPplast",2,0,0,2,2021-11-26
"industry_arena","ClusterCICAT",2,0,0,2,2021-11-26
"industry_arena","innovallcluster",2,0,0,2,2021-11-26
"innotransfer","GVAavi",2,0,0,2,2021-11-26
"iolunadeJupiter","CSIC",1,0,1,2,2021-11-26
"IreneLarroy","ai_eic",2,0,0,2,2021-11-26
"IreneLarroy","AristosInfo",1,0,1,2,2021-11-26
"iResiduo","UVa_es",2,0,0,2,2021-11-26
"ISWA_org","aimplas",2,0,0,2,2021-11-26
"ISWA_org","Centexbel",2,0,0,2,2021-11-26
"ISWA_org","DECOATEU",2,0,0,2,2021-11-26
"ISWA_org","RESCOLL",2,0,0,2,2021-11-26
"ITACYL","aimplas",2,0,0,2,2021-11-26
"ITACYL","FGULEM",2,0,0,2,2021-11-26
"ITACYL","fgusal",2,0,0,2,2021-11-26
"ITACYL","FundacionUBU",2,0,0,2,2021-11-26
"ITACYL","fungeuva",2,0,0,2,2021-11-26
"ItalyFoodTrade","aimplas",2,0,0,2,2021-11-26
"ItalyFoodTrade","Amp_Portofino",2,0,0,2,2021-11-26
"ItalyFoodTrade","ARC2020eu",2,0,0,2,2021-11-26
"ItalyFoodTrade","ARPALiguria",2,0,0,2,2021-11-26
"ItalyFoodTrade","cibmlivorno",2,0,0,2,2021-11-26
"ItalyFoodTrade","Coopitalia",2,0,0,2,2021-11-26
"ItalyFoodTrade","CProplast",2,0,0,2,2021-11-26
"ItalyFoodTrade","ECVC1",2,0,0,2,2021-11-26
"ItalyFoodTrade","FAOfish",2,0,0,2,2021-11-26
"ItalyFoodTrade","FIANista",2,0,0,2,2021-11-26
"ItalyFoodTrade","IFPRI",2,0,0,2,2021-11-26
"ItalyFoodTrade","jwojc",2,0,0,2,2021-11-26
"ItalyFoodTrade","lemonde_planete",2,0,0,2,2021-11-26
"ItalyFoodTrade","nofima",2,0,0,2,2021-11-26
"ItalyFoodTrade","pewglobal",2,0,0,2,2021-11-26
"ItalyFoodTrade","Pouvoirdesidees",2,0,0,2,2021-11-26
"ItalyFoodTrade","primaitaly",2,0,0,2,2021-11-26
"ItalyFoodTrade","PrimaProgram",2,0,0,2,2021-11-26
"ItalyFoodTrade","sthlmresilience",2,0,0,2,2021-11-26
"ItalyFoodTrade","Ticass2012",2,0,0,2,2021-11-26
"ItalyFoodTrade","ubarilan",2,0,0,2,2021-11-26
"ItalyFoodTrade","UnescoChairFood",2,0,0,2,2021-11-26
"ItalyFoodTrade","WWFitalia",2,0,0,2,2021-11-26
"ITC_ceramica","CienciaGob",2,0,0,2,2021-11-26
"ITC_ceramica","GVAavi",2,0,0,2,2021-11-26
"itenergia","grupoenercoop",2,0,0,2,2021-11-26
"itenergia","sapiensenergia",2,0,0,2,2021-11-26
"ITQ_UPVCSIC","aimplas",2,0,0,2,2021-11-26
"ITQ_UPVCSIC","GVAavi",2,0,0,2,2021-11-26
"ITQ_UPVCSIC","IISLaFe",2,0,0,2,2021-11-26
"ITQ_UPVCSIC","ITQ_UPVCSIC",2,0,0,2,2021-11-26
"ITQ_UPVCSIC","UPV",2,0,0,2,2021-11-26
"izarotech","ANAIP_es",2,0,0,2,2021-11-26
"izarotech","BioICEP_IMGGE",1,0,1,2,2021-11-26
"izarotech","raorsamaq",1,0,1,2,2021-11-26
"IzasaScientific","aimplas",1,1,0,2,2021-11-26
"jadfrias","deborahciencia",2,0,0,2,2021-11-26
"jadfrias","SusChemSpain",1,0,1,2,2021-11-26
"JCGarcia_CDTI","aimplas",2,0,0,2,2021-11-26
"JCGarcia_CDTI","CDTIoficial",0,2,0,2,2021-11-26
"jhomstor","AgoraScience",2,0,0,2,2021-11-26
"jhomstor","aimplas",2,0,0,2,2021-11-26
"jhomstor","AvepAsociacion",2,0,0,2,2021-11-26
"jhomstor","Avia_automocion",2,0,0,2,2021-11-26
"jhomstor","CEPplast",2,0,0,2,2021-11-26
"jhomstor","HP",2,0,0,2,2021-11-26
"jhomstor","IAM3DHUB",2,0,0,2,2021-11-26
"jhomstor","industry_arena",2,0,0,2,2021-11-26
"jhomstor","PlasticsEuropES",2,0,0,2,2021-11-26
"joanros78","aimplas",1,0,1,2,2021-11-26
"juliatomas3","ibv_org",1,1,0,2,2021-11-26
"khaqanshati","ALBAsynchrotron",1,0,1,2,2021-11-26
"KimitecGroup","2Bortolozzo",2,0,0,2,2021-11-26
"KimitecGroup","aimenct",2,0,0,2,2021-11-26
"KimitecGroup","CanalUGR",2,0,0,2,2021-11-26
"KimitecGroup","KimitecGroup",0,0,2,2,2021-11-26
"KimitecGroup","mi_sustainable",2,0,0,2,2021-11-26
"KimitecGroup","VITObelgium",2,0,0,2,2021-11-26
"LaBrujulaCV_OCR","aimplas",1,0,1,2,2021-11-26
"lacarolinajaen","skrollerbelt",1,0,1,2,2021-11-26
"LasNavesINN","aimplas",2,0,0,2,2021-11-26
"LasNavesINN","carlosgaliana",2,0,0,2,2021-11-26
"LasNavesINN","FerminCerezo",2,0,0,2,2021-11-26
"LasNavesINN","LasNavesCOLLAB",2,0,0,2,2021-11-26
"LasNavesINN","marta_chillaron",2,0,0,2,2021-11-26
"LifeEpsSure","aimplas",2,0,0,2,2021-11-26
"LifeEpsSure","LIFEprogramme",2,0,0,2,2021-11-26
"lilifondevila","FuturEnviro",1,0,1,2,2021-11-26
"LinkenerSpain","aimplas",2,0,0,2,2021-11-26
"LISSolutionsTW","aimplas",2,0,0,2,2021-11-26
"LolaFPaniagua","aimplas",2,0,0,2,2021-11-26
"londones","PlatinoEduca",1,0,1,2,2021-11-26
"luisagilrj","aimplas",1,0,1,2,2021-11-26
"luispatinoangel","Hispackbcn",1,0,1,2,2021-11-26
"luispatinoangel","omegagenesisca",2,0,0,2,2021-11-26
"MadresXClimaCan","AEMArm",2,0,0,2,2021-11-26
"MadresXClimaCan","aimplas",2,0,0,2,2021-11-26
"MadresXClimaCan","fempcomunica",2,0,0,2,2021-11-26
"MadresXClimaCan","FMRdeMurcia",2,0,0,2,2021-11-26
"MadresXClimaCan","MadresXelClima",2,0,0,2,2021-11-26
"MadresXClimaCan","MurciaClima",2,0,0,2,2021-11-26
"MadresXClimaCan","plastic_britain",2,0,0,2,2021-11-26
"MadresXClimaCan","UpcyclingMadrid",2,0,0,2,2021-11-26
"MadresXClimaCan","Vertidos_Cero",2,0,0,2,2021-11-26
"marijosidemaya","aimplas",2,0,0,2,2021-11-26
"marijosidemaya","AmigosTierraEsp",2,0,0,2,2021-11-26
"marijosidemaya","Ferfollos",2,0,0,2,2021-11-26
"marijosidemaya","FFFSalamanca",2,0,0,2,2021-11-26
"marijosidemaya","ICTA_UAB",2,0,0,2,2021-11-26
"marijosidemaya","MadresXelClima",2,0,0,2,2021-11-26
"marijosidemaya","PaisajeLimpio",2,0,0,2,2021-11-26
"marijosidemaya","Regmurcialimpia",2,0,0,2,2021-11-26
"marijosidemaya","somoscidec",2,0,0,2,2021-11-26
"marijosidemaya","xrmadrid_",2,0,0,2,2021-11-26
"MartaEGMosquera","eldiarioclm",1,1,0,2,2021-11-26
"MartaEGMosquera","GimenoGroup",1,0,1,2,2021-11-26
"Mateprincs","AaronCa04190760",2,0,0,2,2021-11-26
"Mateprincs","LOPECMunich",2,0,0,2,2021-11-26
"Mateprincs","Naitec_CT",2,0,0,2,2021-11-26
"materplat","aimplas",2,0,0,2,2021-11-26
"materplat","ImdeaMaterials",2,0,0,2,2021-11-26
"materplat","La_UPM",2,0,0,2,2021-11-26
"materplat","NavantiaOficial",2,0,0,2,2021-11-26
"MediterraneoPre","capasvil",1,0,1,2,2021-11-26
"MetalMadridEs","CompositesSpain",2,0,0,2,2021-11-26
"MetalMadridEs","MetalMadridEs",2,0,0,2,2021-11-26
"micijor","joveryolanda",1,0,1,2,2021-11-26
"MinarroFin","VAtradu",1,0,1,2,2021-11-26
"miplacebio","Actecosl",2,0,0,2,2021-11-26
"miplacebio","aimplas",2,0,0,2,2021-11-26
"miplacebio","realturfoficial",2,0,0,2,2021-11-26
"mmelgarejo3300","aimplas",1,0,1,2,2021-11-26
"MobilityVlc","aimplas",2,0,0,2,2021-11-26
"Monviciano","Energy4Europe",2,0,0,2,2021-11-26
"Monviciano","EUinKuwait",2,0,0,2,2021-11-26
"Monviciano","EUintheGCC",2,0,0,2,2021-11-26
"Monviciano","EUintheUAE",2,0,0,2,2021-11-26
"Monviciano","ExpoUpdate",2,0,0,2,2021-11-26
"mrtmi3g","asincar",1,1,0,2,2021-11-26
"mtmachado","aimplas",1,0,1,2,2021-11-26
"Mundoplast","ainiatecnologia",2,0,0,2,2021-11-26
"Mundoplast","ANAIP_es",2,0,0,2,2021-11-26
"Mundoplast","ANARPLA",2,0,0,2,2021-11-26
"Mundoplast","Cicloplast_com",2,0,0,2,2021-11-26
"NagrifoodClust","ClusterFPrint",2,0,0,2,2021-11-26
"NontoxProject","aimplas",2,0,0,2,2021-11-26
"NontoxProject","IMDEA_Energia",2,0,0,2,2021-11-26
"Novamont","aimplas",2,0,0,2,2021-11-26
"Novamont","Cicloplast_com",2,0,0,2,2021-11-26
"Novamont_Iberia","Novamont_Iberia",0,0,2,2,2021-11-26
"OanaCaro","aimplas",2,0,0,2,2021-11-26
"OanaCaro","ICTA_UAB",2,0,0,2,2021-11-26
"OanaCaro","PaisajeLimpio",2,0,0,2,2021-11-26
"OanaCaro","somoscidec",2,0,0,2,2021-11-26
"OC_Composites","AEMAC_",2,0,0,2,2021-11-26
"OC_Composites","aimplas",2,0,0,2,2021-11-26
"OC_Composites","aitex_es",2,0,0,2,2021-11-26
"OC_Composites","CDTIoficial",2,0,0,2,2021-11-26
"OC_Composites","CMplastik",2,0,0,2,2021-11-26
"OC_Composites","Colquimva",2,0,0,2,2021-11-26
"OC_Composites","CompositesQuim",2,0,0,2,2021-11-26
"OC_Composites","Feria_Valencia",2,0,0,2,2021-11-26
"OC_Composites","feriaecofira",2,0,0,2,2021-11-26
"OC_Composites","GVAivace",2,0,0,2,2021-11-26
"OC_Composites","InescopTech",2,0,0,2,2021-11-26
"OC_Composites","Redit_es",2,0,0,2,2021-11-26
"OceanetsProject","EU_EASME",2,0,0,2,2021-11-26
"OceanetsProject","uvigo",2,0,0,2,2021-11-26
"OCRValencia","OndaCero_es",2,0,0,2,2021-11-26
"omenendez","SusChemSpain",1,0,1,2,2021-11-26
"opdi_tex_GmbH","CompositeUnited",1,0,1,2,2021-11-26
"OpenFuture_And","byproductplace",1,0,1,2,2021-11-26
"OVTT","OEPM_es",2,0,0,2,2021-11-26
"pablo24200","Vertidos_Cero",1,0,1,2,2021-11-26
"packcluster","industry_arena",1,0,1,2,2021-11-26
"Packnet_","anape",2,0,0,2,2021-11-26
"Packnet_","anape_eps",0,2,0,2,2021-11-26
"Packnet_","CticCita",2,0,0,2,2021-11-26
"Packnet_","EmpackIberia",2,0,0,2,2021-11-26
"Packnet_","iambiente",0,2,0,2,2021-11-26
"Packnet_","packcluster",2,0,0,2,2021-11-26
"Packnet_","PKF_INNCOME",2,0,0,2,2021-11-26
"Packnet_","sigfito",2,0,0,2,2021-11-26
"PacoFernandezA2","MartaEGMosquera",1,0,1,2,2021-11-26
"PactoMundial","aimplas",2,0,0,2,2021-11-26
"parccientificuv","UPCTnoticias",2,0,0,2,2021-11-26
"Pascual","ter4bithi4",1,0,1,2,2021-11-26
"PCT_UCN","GVAivace",1,0,1,2,2021-11-26
"pharmamarket","Biopolis_SL",2,0,0,2,2021-11-26
"pHjools","CentrosCex",1,0,1,2,2021-11-26
"PilMontana","PlasticsEuropES",1,0,1,2,2021-11-26
"PilotHarbour","aimplas",2,0,0,2,2021-11-26
"plastic_museum","aimplas",1,0,1,2,2021-11-26
"PlasticFV","Cicloplast_com",2,0,0,2,2021-11-26
"PlasticFV","Envaspres",2,0,0,2,2021-11-26
"PlasticFV","ITC_Packaging",2,0,0,2,2021-11-26
"PlasticFV","Mundoplast",2,0,0,2,2021-11-26
"plasticomty","10t_proyectos",1,0,1,2,2021-11-26
"PlasticsEuropES","PlasticsEuropES",0,0,2,2,2021-11-26
"PlasticsWorld","Actecosl",2,0,0,2,2021-11-26
"PlasticsWorld","realturfoficial",2,0,0,2,2021-11-26
"platformtierra","aimplas",2,0,0,2,2021-11-26
"PMI_Valencia","aimplas",2,0,0,2,2021-11-26
"PReivindicativa","aimplas",1,0,1,2,2021-11-26
"PT3NEO","aimplas",2,0,0,2,2021-11-26
"PT3NEO","ClusterFPrint",2,0,0,2,2021-11-26
"RachelRock2","AIJU_Tecnologi",1,0,1,2,2021-11-26
"RamnBertNavarro","CSIC",1,0,1,2,2021-11-26
"RamSG20","CSIC",1,0,1,2,2021-11-26
"rappicupons105","i_alimentacion",1,0,1,2,2021-11-26
"reciclajeFER","aimplas",2,0,0,2,2021-11-26
"RECOTRANS_H2020","aimplas",2,0,0,2,2021-11-26
"Recuwaste","ivanalbertos81",1,0,1,2,2021-11-26
"Redit_es","CIDETEC_",2,0,0,2,2021-11-26
"Redit_es","Contact_AMI",2,0,0,2,2021-11-26
"Redit_es","esplasticos",2,0,0,2,2021-11-26
"Redit_es","EU_EASME",1,1,0,2,2021-11-26
"Redit_es","garcia_saludes",2,0,0,2,2021-11-26
"Redit_es","Julia_company",2,0,0,2,2021-11-26
"Redit_es","mincoturgob",2,0,0,2,2021-11-26
"Redit_es","OndaCero_es",2,0,0,2,2021-11-26
"Redit_es","plastic_museum",2,0,0,2,2021-11-26
"Redit_es","Rafa_Climentg",2,0,0,2,2021-11-26
"Redit_es","ServiReach",2,0,0,2,2021-11-26
"Redit_es","UPV",2,0,0,2,2021-11-26
"Regmurcialimpia","basurasmarinas",2,0,0,2,2021-11-26
"Regmurcialimpia","BIOnTop_Project",1,0,1,2,2021-11-26
"Regmurcialimpia","FuturEnviro",1,0,1,2,2021-11-26
"Regmurcialimpia","Regmurcialimpia",0,0,2,2,2021-11-26
"Regmurcialimpia","THADERCONSUMO",2,0,0,2,2021-11-26
"REMADYL_EU","aimplas",2,0,0,2,2021-11-26
"REMADYL_EU","azorambiental",2,0,0,2,2021-11-26
"REMADYL_EU","Centexbel",2,0,0,2,2021-11-26
"REMADYL_EU","DANOSA_SPAIN",2,0,0,2,2021-11-26
"REMADYL_EU","Deceuninck",2,0,0,2,2021-11-26
"REMADYL_EU","iris_rd",2,0,0,2,2021-11-26
"REMADYL_EU","REMADYL_EU",1,1,0,2,2021-11-26
"REMADYL_EU","SPIRE2030",1,1,0,2,2021-11-26
"REMADYL_EU","SustainableInnE",2,0,0,2,2021-11-26
"REMADYL_EU","UV_EG",2,0,0,2,2021-11-26
"REMADYL_EU","Vinylplus_it",2,0,0,2,2021-11-26
"RepetCoinnova","Cicloplast_com",2,0,0,2,2021-11-26
"RepetCoinnova","RepetCoinnova",2,0,0,2,2021-11-26
"reverdeconcausa","hasta_el_lunes",1,0,1,2,2021-11-26
"RevistaMercados","Afi_es",2,0,0,2,2021-11-26
"RevistaMercados","ANAIP_es",2,0,0,2,2021-11-26
"RevistaMercados","ANARPLA",2,0,0,2,2021-11-26
"RevistaMercados","fCIRCE",2,0,0,2,2021-11-26
"RevistaMercados","ICTA_UAB",2,0,0,2,2021-11-26
"RevistaMercados","IDAEA_CSIC",2,0,0,2,2021-11-26
"RevistaMercados","PaisajeLimpio",2,0,0,2,2021-11-26
"RevistaMercados","somoscidec",2,0,0,2,2021-11-26
"RevistaMercados","Vertidos_Cero",2,0,0,2,2021-11-26
"RevistaRETEMA","ANARPLA",2,0,0,2,2021-11-26
"RevistaRETEMA","InescopTech",2,0,0,2,2021-11-26
"rrecycling","aimplas",2,0,0,2,2021-11-26
"SagredoMarco","AIDIMME",2,0,0,2,2021-11-26
"SanchisFederico","AdelaRuizD",2,0,0,2,2021-11-26
"SanchisFederico","ITI_TIC",2,0,0,2,2021-11-26
"SanchisFederico","SanchisFederico",0,0,2,2,2021-11-26
"Santa_Teresa","ITACYL",1,1,0,2,2021-11-26
"SDDR_info","FuturEnviro",1,0,1,2,2021-11-26
"SENA_RValle","SENA_RValle",1,0,1,2,2021-11-26
"silviaavilesg","Cicloplast_com",2,0,0,2,2021-11-26
"silviaavilesg","esplasticos",2,0,0,2,2021-11-26
"SmartCityJour_","aimplas",1,0,1,2,2021-11-26
"SOMM_alliance","Afi_es",2,0,0,2,2021-11-26
"SOMM_alliance","aimplas",2,0,0,2,2021-11-26
"SOMM_alliance","fCIRCE",2,0,0,2,2021-11-26
"SOMM_alliance","PaisajeLimpio",2,0,0,2,2021-11-26
"SOMM_alliance","somoscidec",2,0,0,2,2021-11-26
"SOMM_alliance","Vertidos_Cero",2,0,0,2,2021-11-26
"somoscidec","Vertidos_Cero",2,0,0,2,2021-11-26
"SoniaHe49592177","CSIC",1,0,1,2,2021-11-26
"SoniTirado","aimplas",1,0,1,2,2021-11-26
"SreeparnaDas20","aimplas",1,0,1,2,2021-11-26
"tabitbilisim","Azmudeu",1,1,0,2,2021-11-26
"tabitbilisim","tabitbilisim",2,0,0,2,2021-11-26
"talk2much12","itene",2,0,0,2,2021-11-26
"tecnalia","pteco2",1,1,0,2,2021-11-26
"Tecnifood","ainiatecnologia",2,0,0,2,2021-11-26
"Tecnifood","ANARPLA",2,0,0,2,2021-11-26
"Tecnifood","Biopolis_SL",2,0,0,2,2021-11-26
"Tecnifood","espaitec",2,0,0,2,2021-11-26
"tecnoaqua","AseTUB",1,0,1,2,2021-11-26
"tecplastico","aimplas",2,0,0,2,2021-11-26
"TitoCrissien","aimplas",2,0,0,2,2021-11-26
"TRAKTECH_","AvepAsociacion",2,0,0,2,2021-11-26
"ucvalencia","Redit_es",1,0,1,2,2021-11-26
"UNLOCK_BBI","aimplas",2,0,0,2,2021-11-26
"veredictas","int_envase",2,0,0,2,2021-11-26
"veredictas","salesianssarria",2,0,0,2,2021-11-26
"Vertidos_Cero","ecoalf",2,0,0,2,2021-11-26
"Vertidos_Cero","FValenciaport",2,0,0,2,2021-11-26
"Vertidos_Cero","mitecogob",2,0,0,2,2021-11-26
"Vertidos_Cero","pablo24200",1,0,1,2,2021-11-26
"Vertidos_Cero","RubenRguezAl",1,0,1,2,2021-11-26
"VicenteAbella","MinarroFin",1,0,1,2,2021-11-26
"vincenzo_gente","aimplas",1,0,1,2,2021-11-26
"VLCTechCity","aimplas",2,0,0,2,2021-11-26
"Wendy_Moreno_EU","accio_cat",2,0,0,2,2021-11-26
"Wendy_Moreno_EU","aimplas",2,0,0,2,2021-11-26
"Wendy_Moreno_EU","AristosInfo",2,0,0,2,2021-11-26
"Wendy_Moreno_EU","biocat_cat",2,0,0,2,2021-11-26
"Wendy_Moreno_EU","CDTIoficial",2,0,0,2,2021-11-26
"Wendy_Moreno_EU","eencat",2,0,0,2,2021-11-26
"Wendy_Moreno_EU","Eurecat_news",2,0,0,2,2021-11-26
"Wendy_Moreno_EU","H2020_Partner",2,0,0,2,2021-11-26
"Wendy_Moreno_EU","horizonexperts",2,0,0,2,2021-11-26
"Wendy_Moreno_EU","IreneLarroy",2,0,0,2,2021-11-26
"Wendy_Moreno_EU","itene",2,0,0,2,2021-11-26
"Wendy_Moreno_EU","JCGarcia_CDTI",2,0,0,2,2021-11-26
"Wendy_Moreno_EU","jordipietx",2,0,0,2,2021-11-26
"Wendy_Moreno_EU","RosaAriasAlv",2,0,0,2,2021-11-26
"Wendy_Moreno_EU","scibus",2,0,0,2,2021-11-26
"Wendy_Moreno_EU","SorosGabinete",2,0,0,2,2021-11-26
"Wendy_Moreno_EU","talk2much12",2,0,0,2,2021-11-26
"WomenInPlastic","BritishPlastics",1,1,0,2,2021-11-26
"WriterAlejandro","Agrimax_EU",1,0,1,2,2021-11-26
"x_campos","aimplas",1,0,1,2,2021-11-26
"_rtvemarcae","aimplas",1,0,0,1,2021-11-26
"1785es","AceitesOlivaES",1,0,0,1,2021-11-26
"1785es","aimplas",1,0,0,1,2021-11-26
"1785es","andaluciae",1,0,0,1,2021-11-26
"1785es","cadecordobaAE",1,0,0,1,2021-11-26
"1785es","CordobaBN",1,0,0,1,2021-11-26
"1785es","elespanolcom",1,0,0,1,2021-11-26
"3duardoFG","aimplas",1,0,0,1,2021-11-26
"3duardoFG","ANAIP_es",1,0,0,1,2021-11-26
"3duardoFG","charo_barroso",1,0,0,1,2021-11-26
"3duardoFG","Cicloplast_com",1,0,0,1,2021-11-26
"3duardoFG","esplasticos",1,0,0,1,2021-11-26
"3duardoFG","greenpeace_esp",1,0,0,1,2021-11-26
"3duardoFG","PlasticsEuropES",1,0,0,1,2021-11-26
"3duardoFG","StockTerabithia",1,0,0,1,2021-11-26
"3duardoFG","TFundaciones",1,0,0,1,2021-11-26
"3Recycler","aimplas",1,0,0,1,2021-11-26
"3Recycler","ANAIP_es",1,0,0,1,2021-11-26
"3Recycler","Cicloplast_com",1,0,0,1,2021-11-26
"3Recycler","esplasticos",1,0,0,1,2021-11-26
"3Recycler","eurenext",1,0,0,1,2021-11-26
"7TeleValencia","aimplas",1,0,0,1,2021-11-26
"aalbaperez","_iterh_",1,0,0,1,2021-11-26
"aalbaperez","AIDIMME",1,0,0,1,2021-11-26
"aalbaperez","itenergia",1,0,0,1,2021-11-26
"AbelardoDuran","ANAIP_es",1,0,0,1,2021-11-26
"AbelardoDuran","Cicloplast_com",1,0,0,1,2021-11-26
"AbelardoDuran","silviaavilesg",0,0,1,1,2021-11-26
"acanocoloma","aimplas",1,0,0,1,2021-11-26
"acanocoloma","CentrosCex",1,0,0,1,2021-11-26
"acanocoloma","escamilla50",1,0,0,1,2021-11-26
"acanocoloma","generalitat",1,0,0,1,2021-11-26
"acanocoloma","GVAivace",1,0,0,1,2021-11-26
"acanocoloma","Julia_company",1,0,0,1,2021-11-26
"acanocoloma","Rafa_Climentg",1,0,0,1,2021-11-26
"Actecosl","aimplas",1,0,0,1,2021-11-26
"Actuenviro","aimplas",1,0,0,1,2021-11-26
"Actuenviro","Benkei_Fr",1,0,0,1,2021-11-26
"Actuenviro","CT_IPC",1,0,0,1,2021-11-26
"Actuenviro","filigrade",1,0,0,1,2021-11-26
"Actuenviro","PellencGroup",1,0,0,1,2021-11-26
"Actuenviro","Pollutec",1,0,0,1,2021-11-26
"Actuenviro","ProspexInst",1,0,0,1,2021-11-26
"ADBioplastics","ADBioplastics",1,0,0,1,2021-11-26
"ADBioplastics","aimplas",1,0,0,1,2021-11-26
"ADBioplastics","bioplasticsmag",1,0,0,1,2021-11-26
"ADBioplastics","TotalCorbionPLA",1,0,0,1,2021-11-26
"ADCV_com","AIDIMME",1,0,0,1,2021-11-26
"ADCV_com","AIJU_Tecnologi",1,0,0,1,2021-11-26
"ADCV_com","aimplas",1,0,0,1,2021-11-26
"ADCV_com","ainiatecnologia",1,0,0,1,2021-11-26
"ADCV_com","aitex_es",1,0,0,1,2021-11-26
"ADCV_com","ibv_org",1,0,0,1,2021-11-26
"ADCV_com","InescopTech",1,0,0,1,2021-11-26
"ADCV_com","ITC_ceramica",1,0,0,1,2021-11-26
"ADCV_com","itene",1,0,0,1,2021-11-26
"ADCV_com","itenergia",1,0,0,1,2021-11-26
"ADCV_com","ITI_TIC",1,0,0,1,2021-11-26
"AdonaiHM","asociacionruvid",1,0,0,1,2021-11-26
"AdonaiHM","AVEmpresarios",1,0,0,1,2021-11-26
"AdonaiHM","c_valenciana",1,0,0,1,2021-11-26
"AdonaiHM","emparmbonafe",1,0,0,1,2021-11-26
"AdonaiHM","FundacionETNOR",1,0,0,1,2021-11-26
"AdonaiHM","GVAavi",1,0,0,1,2021-11-26
"AdonaiHM","GVAddigital",1,0,0,1,2021-11-26
"AdonaiHM","GVAinnova",1,0,0,1,2021-11-26
"AdonaiHM","ITC_ceramica",1,0,0,1,2021-11-26
"AdonaiHM","PremiosReiJaume",1,0,0,1,2021-11-26
"AdonaiHM","RectoraUA",1,0,0,1,2021-11-26
"AdonaiHM","UA_Universidad",1,0,0,1,2021-11-26
"AdvanFactories","AEMAC_",1,0,0,1,2021-11-26
"AdvanFactories","Airbus",1,0,0,1,2021-11-26
"AdvanFactories","CDTIoficial",1,0,0,1,2021-11-26
"AdvanFactories","DANOBATGROUP",1,0,0,1,2021-11-26
"AdvanFactories","industriQuimica",1,0,0,1,2021-11-26
"AdvanFactories","infoedita",1,0,0,1,2021-11-26
"AdvanFactories","TalgoGroup",1,0,0,1,2021-11-26
"AdvanFactories","UdGPolitecnica",1,0,0,1,2021-11-26
"aec_es","eurofirms",1,0,0,1,2021-11-26
"aec_es","Kapture_io",1,0,0,1,2021-11-26
"aec_es","rnconsulting_es",1,0,0,1,2021-11-26
"aec_es","Sisteplant",1,0,0,1,2021-11-26
"aec_es","tuSEAT",1,0,0,1,2021-11-26
"aec_es","ZF_Group",1,0,0,1,2021-11-26
"AEMAC_","AdvanFactories",1,0,0,1,2021-11-26
"AEMAC_","AlestisAerospac",1,0,0,1,2021-11-26
"AEMAC_","Arkema_group",1,0,0,1,2021-11-26
"AEMAC_","ascameorg",1,0,0,1,2021-11-26
"AEMAC_","camarascomercio",1,0,0,1,2021-11-26
"AEMAC_","cambrabcn",1,0,0,1,2021-11-26
"AEMAC_","DANOBAT",1,0,0,1,2021-11-26
"AEMAC_","eoi",1,0,0,1,2021-11-26
"AEMAC_","EsAirbus",1,0,0,1,2021-11-26
"AEMAC_","Eurecat",1,0,0,1,2021-11-26
"AEMAC_","Fraunhofer",1,0,0,1,2021-11-26
"AEMAC_","IFEMA",1,0,0,1,2021-11-26
"AEMAC_","industrialesand",1,0,0,1,2021-11-26
"AEMAC_","itea",1,0,0,1,2021-11-26
"AEMAC_","iteamUPV",1,0,0,1,2021-11-26
"AEMAC_","MADRID",1,0,0,1,2021-11-26
"AEMAC_","MaterialCharact",1,0,0,1,2021-11-26
"AEMAC_","MetalMadridEs",1,0,0,1,2021-11-26
"AEMAC_","MtorresRsc",1,0,0,1,2021-11-26
"AEMAC_","MUnibertsitatea",1,0,0,1,2021-11-26
"AEMAC_","packcluster",1,0,0,1,2021-11-26
"AEMAC_","PatronalCecot",1,0,0,1,2021-11-26
"AEMAC_","PlasticsEurope",1,0,0,1,2021-11-26
"AEMAC_","silviaavilesg",0,0,1,1,2021-11-26
"AEMAC_","SusChemSpain",1,0,0,1,2021-11-26
"AEMAC_","talgo",1,0,0,1,2021-11-26
"AEMAC_","uc3m",1,0,0,1,2021-11-26
"AEMAC_","UdGPolitecnica",1,0,0,1,2021-11-26
"AEMAC_","unisevilla",1,0,0,1,2021-11-26
"AEMAC_","ZundCutter",1,0,0,1,2021-11-26
"AErasmusproject","MedScan3D",1,0,0,1,2021-11-26
"AErasmusproject","TheAMRC",1,0,0,1,2021-11-26
"aevae_es","aimplas",1,0,0,1,2021-11-26
"aevae_es","Cicloplast_com",1,0,0,1,2021-11-26
"afercuello","aimplas",1,0,0,1,2021-11-26
"afercuello","AragonCircular",1,0,0,1,2021-11-26
"afercuello","AytoCalatayud",1,0,0,1,2021-11-26
"afercuello","CAARAUTOARAGON",1,0,0,1,2021-11-26
"agapi_comunica","aimplas",1,0,0,1,2021-11-26
"agapi_comunica","corifyAF",1,0,0,1,2021-11-26
"agapi_comunica","Grupo_TSK",1,0,0,1,2021-11-26
"agapi_comunica","Molecor",1,0,0,1,2021-11-26
"agapi_comunica","PigCHAMP_Europa",1,0,0,1,2021-11-26
"agapi_comunica","skrollerbelt",1,0,0,1,2021-11-26
"AgoraScience","AgoraScience",0,1,0,1,2021-11-26
"AgoraScience","astro_duque",1,0,0,1,2021-11-26
"AgoraScience","AureaRodriguezL",1,0,0,1,2021-11-26
"AgoraScience","CDTIoficial",1,0,0,1,2021-11-26
"AgoraScience","CEPplast",1,0,0,1,2021-11-26
"AgoraScience","CienciaGob",1,0,0,1,2021-11-26
"AgoraScience","CtqcQuimica",1,0,0,1,2021-11-26
"AgoraScience","Equiplast",1,0,0,1,2021-11-26
"AgoraScience","fecyt",1,0,0,1,2021-11-26
"AgoraScience","FECYT_Ciencia",1,0,0,1,2021-11-26
"AgoraScience","GraphispackAsoc",1,0,0,1,2021-11-26
"AgoraScience","graphispag2021",1,0,0,1,2021-11-26
"AgoraScience","idibaps",1,0,0,1,2021-11-26
"AgoraScience","IndustriaGob",1,0,0,1,2021-11-26
"AgoraScience","industry_arena",1,0,0,1,2021-11-26
"AgoraScience","jsanfeliu",1,0,0,1,2021-11-26
"AgoraScience","JSansaloni",1,0,0,1,2021-11-26
"AgoraScience","marcvidal",1,0,0,1,2021-11-26
"AgoraScience","PlasticsEurope",1,0,0,1,2021-11-26
"AgoraScience","x_grauvidal",1,0,0,1,2021-11-26
"AgoraScience","xcampscoma",1,0,0,1,2021-11-26
"Agrimax_EU","bioplasticsmag",1,0,0,1,2021-11-26
"agrodhuelva","aimplas",1,0,0,1,2021-11-26
"agrodhuelva","ainiatecnologia",1,0,0,1,2021-11-26
"agromac_mm","aimplas",1,0,0,1,2021-11-26
"AgroNewsCV","ANAIP_es",1,0,0,1,2021-11-26
"AgroNewsCV","ITI_TIC",1,0,0,1,2021-11-26
"AgroNewsCV","Nestle_es",1,0,0,1,2021-11-26
"AgronoticiasE","aimplas",1,0,0,1,2021-11-26
"aguaresiduales","aimplas",1,0,0,1,2021-11-26
"Aida_Herranz","Aida_Herranz",0,0,1,1,2021-11-26
"Aida_Herranz","aimplas",1,0,0,1,2021-11-26
"Aida_Herranz","EU_H2020",1,0,0,1,2021-11-26
"Aida_Herranz","ffe_es",1,0,0,1,2021-11-26
"Aida_Herranz","FoF_EU",1,0,0,1,2021-11-26
"Aida_Herranz","materplat",1,0,0,1,2021-11-26
"Aida_Herranz","RECOTRANS_H2020",1,0,0,1,2021-11-26
"AIJU_Tecnologi","AIDIMME",1,0,0,1,2021-11-26
"AIJU_Tecnologi","ainiatecnologia",1,0,0,1,2021-11-26
"AIJU_Tecnologi","aitex_es",1,0,0,1,2021-11-26
"AIJU_Tecnologi","AvamedSynergy",1,0,0,1,2021-11-26
"AIJU_Tecnologi","floridauni",1,0,0,1,2021-11-26
"AIJU_Tecnologi","FundacionVithas",1,0,0,1,2021-11-26
"AIJU_Tecnologi","ibv_org",1,0,0,1,2021-11-26
"AIJU_Tecnologi","InescopTech",1,0,0,1,2021-11-26
"AIJU_Tecnologi","ITC_ceramica",1,0,0,1,2021-11-26
"AIJU_Tecnologi","itene",1,0,0,1,2021-11-26
"AIJU_Tecnologi","itenergia",1,0,0,1,2021-11-26
"AIJU_Tecnologi","ITI_TIC",1,0,0,1,2021-11-26
"AIJU_Tecnologi","quibim",1,0,0,1,2021-11-26
"AIJU_Tecnologi","Vithas",1,0,0,1,2021-11-26
"aimplas","AIDIMME",1,0,0,1,2021-11-26
"aimplas","ainiatecnologia",1,0,0,1,2021-11-26
"aimplas","ANAIP_es",1,0,0,1,2021-11-26
"aimplas","ANARPLA",1,0,0,1,2021-11-26
"aimplas","AvepAsociacion",1,0,0,1,2021-11-26
"aimplas","basurasmarinas",1,0,0,1,2021-11-26
"aimplas","Cicloplast_com",1,0,0,1,2021-11-26
"aimplas","FGlobalis",1,0,0,1,2021-11-26
"aimplas","PlasticsEurope",1,0,0,1,2021-11-26
"aimplas","udem",1,0,0,1,2021-11-26
"aimplas","UV_EG",1,0,0,1,2021-11-26
"AIN_Navarra","aimplas",1,0,0,1,2021-11-26
"ainiatecnologia","CdeCarnica",1,0,0,1,2021-11-26
"ainiatecnologia","danone_es",1,0,0,1,2021-11-26
"ainiatecnologia","DulcesNoticias",1,0,0,1,2021-11-26
"ainiatecnologia","elEconomistaes",1,0,0,1,2021-11-26
"ainiatecnologia","faerchgroup",1,0,0,1,2021-11-26
"ainiatecnologia","FEDACOVA_VLC",1,0,0,1,2021-11-26
"ainiatecnologia","GrupoHinojosa",1,0,0,1,2021-11-26
"ainiatecnologia","GVAsanitat",1,0,0,1,2021-11-26
"ainiatecnologia","i_alimentacion",1,0,0,1,2021-11-26
"ainiatecnologia","PackagingEurope",1,0,0,1,2021-11-26
"ainiatecnologia","Redit_es",1,0,0,1,2021-11-26
"ainiatecnologia","revistaide",1,0,0,1,2021-11-26
"ainiatecnologia","RevistaRETEMA",1,0,0,1,2021-11-26
"ainiatecnologia","RSM_es",1,0,0,1,2021-11-26
"ainiatecnologia","tecnoalimen",1,0,0,1,2021-11-26
"AIPIAcongress","AIPIAcongress",1,0,0,1,2021-11-26
"AIPIAcongress","AmbrosusAMB",1,0,0,1,2021-11-26
"AIPIAcongress","AmirKhoshniyati",1,0,0,1,2021-11-26
"ait_research","AIT_Quality",1,0,0,1,2021-11-26
"ait_research","ait_research",0,1,0,1,2021-11-26
"ait_research","AlisonNiEochaid",1,0,0,1,2021-11-26
"ait_research","DeclanMDevine",1,0,0,1,2021-11-26
"ait_research","Dept_ECC",1,0,0,1,2021-11-26
"ait_research","DeptofFHed",1,0,0,1,2021-11-26
"ait_research","DrollPeter",0,1,0,1,2021-11-26
"ait_research","Horizon2020_ire",1,0,0,1,2021-11-26
"ait_research","HorizonEuropeIE",1,0,0,1,2021-11-26
"ait_research","ibetportugal",1,0,0,1,2021-11-26
"ait_research","MixUp_H2020",1,0,0,1,2021-11-26
"ait_research","paintclubHQ",1,0,0,1,2021-11-26
"ait_research","tuc_tweet",1,0,0,1,2021-11-26
"ait_research","TUS_ie",0,1,0,1,2021-11-26
"Albaladm","aimplas",1,0,0,1,2021-11-26
"Albaladm","CEU_UIA",1,0,0,1,2021-11-26
"Albaladm","CTplasUy",0,1,0,1,2021-11-26
"Albaladm","gmunozabogabir",1,0,0,1,2021-11-26
"Albaladm","GuilleGonzalezC",1,0,0,1,2021-11-26
"Albaladm","MAmbienteuy",1,0,0,1,2021-11-26
"Albaladm","MinamPeru",1,0,0,1,2021-11-26
"Albaladm","MMAChile",1,0,0,1,2021-11-26
"Albaladm","ONUDI_ALC",1,0,0,1,2021-11-26
"Albaladm","ONUDI_conosur",1,0,0,1,2021-11-26
"Albaladm","ONUDI_Mexico",1,0,0,1,2021-11-26
"Albaladm","ONUDIColombia",1,0,0,1,2021-11-26
"Albaladm","SofofaChile",1,0,0,1,2021-11-26
"Albaladm","UIP_py",1,0,0,1,2021-11-26
"Albaladm","UIPBA",1,0,0,1,2021-11-26
"ALBAsynchrotron","aimplas",1,0,0,1,2021-11-26
"ALBAsynchrotron","CalipsoPlus",1,0,0,1,2021-11-26
"ALBAsynchrotron","cepyme_",1,0,0,1,2021-11-26
"ALBAsynchrotron","confemetal",1,0,0,1,2021-11-26
"ALBAsynchrotron","Feique_ES",1,0,0,1,2021-11-26
"alcaide_mkt","aimplas",1,0,0,1,2021-11-26
"almar_laura","aimplas",1,0,0,1,2021-11-26
"almar_laura","CSIC",1,0,0,1,2021-11-26
"almar_laura","eCOCOO2",1,0,0,1,2021-11-26
"almar_laura","expo2020dubai",1,0,0,1,2021-11-26
"almar_laura","ExpoSpain2020",1,0,0,1,2021-11-26
"almar_laura","icareplast",1,0,0,1,2021-11-26
"AlmuAlbertos","aimplas",1,0,0,1,2021-11-26
"AlmuAlbertos","corifyAF",1,0,0,1,2021-11-26
"AlmuAlbertos","Grupo_TSK",1,0,0,1,2021-11-26
"AlmuAlbertos","Molecor",1,0,0,1,2021-11-26
"AlmuAlbertos","PigCHAMP_Europa",1,0,0,1,2021-11-26
"AlmuAlbertos","PlatinoEduca",1,0,0,1,2021-11-26
"AlmuAlbertos","skrollerbelt",1,0,0,1,2021-11-26
"aLuciernaga_","aimplas",1,0,0,1,2021-11-26
"Alvaro_Eslu","GrupoCosentino",1,0,0,1,2021-11-26
"Alvaro_Eslu","UV_EG",1,0,0,1,2021-11-26
"alvizlo","aimplas",1,0,0,1,2021-11-26
"alvizlo","ainiatecnologia",1,0,0,1,2021-11-26
"alvizlo","alvizlo",0,0,1,1,2021-11-26
"ambienteeuropeo","aimplas",1,0,0,1,2021-11-26
"ambienteeuropeo","levante_emv",1,0,0,1,2021-11-26
"Amgarve","Cicloplast_com",1,0,0,1,2021-11-26
"Amgarve","Consum",1,0,0,1,2021-11-26
"Amgarve","eversiagroup",1,0,0,1,2021-11-26
"Amgarve","SaicaGroup_es",1,0,0,1,2021-11-26
"anacanoarribas","anacanoarribas",0,0,1,1,2021-11-26
"anacanoarribas","CoopsAgroES",1,0,0,1,2021-11-26
"anacanoarribas","GVAagroambient",1,0,0,1,2021-11-26
"anacanoarribas","GVAavi",1,0,0,1,2021-11-26
"anacanoarribas","GVAivace",1,0,0,1,2021-11-26
"anacanoarribas","UpvCeqa",1,0,0,1,2021-11-26
"ANAIP_es","ainiatecnologia",1,0,0,1,2021-11-26
"ANAIP_es","ANAIP_es",0,0,1,1,2021-11-26
"ANAIP_es","ANARPLA",1,0,0,1,2021-11-26
"ANAIP_es","AvepAsociacion",1,0,0,1,2021-11-26
"ANAIP_es","CENER_Energia",1,0,0,1,2021-11-26
"ANAIP_es","ChemRecycleNews",1,0,0,1,2021-11-26
"ANAIP_es","deborahciencia",1,0,0,1,2021-11-26
"ANAIP_es","PlasticsEurope",1,0,0,1,2021-11-26
"ANAIP_es","SusChemSpain",1,0,0,1,2021-11-26
"anape_eps","ANAIP_es",1,0,0,1,2021-11-26
"anape_eps","ANARPLA",1,0,0,1,2021-11-26
"anape_eps","COEXPAN_",1,0,0,1,2021-11-26
"anape_eps","EU_EASME",1,0,0,1,2021-11-26
"anape_eps","LifeEpsSure",1,0,0,1,2021-11-26
"anape_eps","LIFEprogramme",1,0,0,1,2021-11-26
"anape_eps","PlasticsEuropES",1,0,0,1,2021-11-26
"AndreaCasoF","AIDIMME",1,0,0,1,2021-11-26
"AndreaCasoF","AIJU_Tecnologi",1,0,0,1,2021-11-26
"AndreaCasoF","aimplas",1,0,0,1,2021-11-26
"AndreaCasoF","ainiatecnologia",1,0,0,1,2021-11-26
"AndreaCasoF","aitex_es",1,0,0,1,2021-11-26
"AndreaCasoF","ibv_org",1,0,0,1,2021-11-26
"AndreaCasoF","InescopTech",1,0,0,1,2021-11-26
"AndreaCasoF","ITC_ceramica",1,0,0,1,2021-11-26
"AndreaCasoF","itene",1,0,0,1,2021-11-26
"AndreaCasoF","itenergia",1,0,0,1,2021-11-26
"AndreaCasoF","ITI_TIC",1,0,0,1,2021-11-26
"andresgilnogues","CEPplast",1,0,0,1,2021-11-26
"andresgilnogues","Cicloplast_com",1,0,0,1,2021-11-26
"andresgilnogues","esplasticos",1,0,0,1,2021-11-26
"andresgilnogues","feria_encaja",1,0,0,1,2021-11-26
"andresgilnogues","feriaecofira",1,0,0,1,2021-11-26
"andresgilnogues","NatxoCosta",1,0,0,1,2021-11-26
"andresgilnogues","PlasticsEuropES",1,0,0,1,2021-11-26
"andresgilnogues","Rafa_Climentg",1,0,0,1,2021-11-26
"andresgilnogues","RETO16CIMAS",1,0,0,1,2021-11-26
"aneabe","aimplas",1,0,0,1,2021-11-26
"aneabe","aneabe",1,0,0,1,2021-11-26
"Angel_Molinero","aimplas",1,0,0,1,2021-11-26
"Angel_Molinero","CECOes_",1,0,0,1,2021-11-26
"AnjanaLeon","aimplas",1,0,0,1,2021-11-26
"AnjanaLeon","corifyAF",1,0,0,1,2021-11-26
"AnjanaLeon","Grupo_TSK",1,0,0,1,2021-11-26
"AnjanaLeon","Molecor",1,0,0,1,2021-11-26
"AnjanaLeon","PigCHAMP_Europa",1,0,0,1,2021-11-26
"AnjanaLeon","PlatinoEduca",1,0,0,1,2021-11-26
"AnjanaLeon","skrollerbelt",1,0,0,1,2021-11-26
"AnsiaDe","afaquim_asoc",1,0,0,1,2021-11-26
"AnsiaDe","ANARPLA",1,0,0,1,2021-11-26
"AnsiaDe","ChemSpain",1,0,0,1,2021-11-26
"AnsiaDe","davidorreta",1,0,0,1,2021-11-26
"AnsiaDe","Equiplast",1,0,0,1,2021-11-26
"AnsiaDe","Eurosurfas",1,0,0,1,2021-11-26
"AnsiaDe","expoquimia",1,0,0,1,2021-11-26
"AnsiaDe","Feique_ES",1,0,0,1,2021-11-26
"AnsiaDe","Fira_Barcelona",1,0,0,1,2021-11-26
"AnsiaDe","ForoQyS",1,0,0,1,2021-11-26
"AnsiaDe","FuturEnviro",1,0,0,1,2021-11-26
"AnsiaDe","residuscat",1,0,0,1,2021-11-26
"AnsiaDe","RevistaRETEMA",1,0,0,1,2021-11-26
"apk_ag","aimplas",1,0,0,1,2021-11-26
"apk_ag","ECOS_Standard",1,0,0,1,2021-11-26
"apk_ag","Eunomia_RandC",1,0,0,1,2021-11-26
"apk_ag","EuRIC_Recycling",1,0,0,1,2021-11-26
"apk_ag","pcepeu",1,0,0,1,2021-11-26
"apk_ag","Umweltbundesamt",1,0,0,1,2021-11-26
"apk_ag","umweltstiftung",1,0,0,1,2021-11-26
"Aqua_Radar","aimplas",1,0,0,1,2021-11-26
"AristosInfo","accio_cat",1,0,0,1,2021-11-26
"AristosInfo","aimplas",1,0,0,1,2021-11-26
"AristosInfo","biocat_cat",1,0,0,1,2021-11-26
"AristosInfo","CDTIoficial",1,0,0,1,2021-11-26
"AristosInfo","eencat",1,0,0,1,2021-11-26
"AristosInfo","Eurecat_news",1,0,0,1,2021-11-26
"AristosInfo","H2020_Partner",1,0,0,1,2021-11-26
"AristosInfo","horizonexperts",1,0,0,1,2021-11-26
"AristosInfo","IreneLarroy",1,0,0,1,2021-11-26
"AristosInfo","itene",1,0,0,1,2021-11-26
"AristosInfo","JCGarcia_CDTI",1,0,0,1,2021-11-26
"AristosInfo","jordipietx",1,0,0,1,2021-11-26
"AristosInfo","RosaAriasAlv",1,0,0,1,2021-11-26
"AristosInfo","scibus",1,0,0,1,2021-11-26
"AristosInfo","SorosGabinete",1,0,0,1,2021-11-26
"AristosInfo","talk2much12",1,0,0,1,2021-11-26
"AristosInfo","Wendy_Moreno_EU",1,0,0,1,2021-11-26
"Arturolarena","BelenFranch",1,0,0,1,2021-11-26
"Arturolarena","cdcampo1",1,0,0,1,2021-11-26
"Arturolarena","EFEverde",1,0,0,1,2021-11-26
"Arturolarena","Oceanografic_vl",1,0,0,1,2021-11-26
"Arturolarena","Redit_es",1,0,0,1,2021-11-26
"Arturolarena","trypanus",1,0,0,1,2021-11-26
"ArviInnovapesca","aimplas",1,0,0,1,2021-11-26
"ArviInnovapesca","ArviInnovapesca",1,0,0,1,2021-11-26
"ArviInnovapesca","ecoalf",1,0,0,1,2021-11-26
"ArviInnovapesca","OceanetsProject",1,0,0,1,2021-11-26
"ArviInnovapesca","uvigo",1,0,0,1,2021-11-26
"ArviInnovapesca","Vertidos_Cero",1,0,0,1,2021-11-26
"AsajaNacional","aimplas",1,0,0,1,2021-11-26
"Asefapi_Es","AIDIMME",1,0,0,1,2021-11-26
"Asefapi_Es","AIJU_Tecnologi",1,0,0,1,2021-11-26
"Asefapi_Es","Asefapi_Es",0,0,1,1,2021-11-26
"Asefapi_Es","CIDETEC_",1,0,0,1,2021-11-26
"Asefapi_Es","ensateclab",1,0,0,1,2021-11-26
"Asefapi_Es","INEGIPORTO",1,0,0,1,2021-11-26
"Asefapi_Es","ITAINNOVA",1,0,0,1,2021-11-26
"Asefapi_Es","Neurtek",1,0,0,1,2021-11-26
"Asefapi_Es","tecnalia",1,0,0,1,2021-11-26
"Asesoria_Tefico","aimplas",1,0,0,1,2021-11-26
"Asesoria_Tefico","inbiotecenlared",1,0,0,1,2021-11-26
"Asesoria_Tefico","UAHes",1,0,0,1,2021-11-26
"AseTUB","ANAIP_es",1,0,0,1,2021-11-26
"AseTUB","applus",1,0,0,1,2021-11-26
"AseTUB","emasesa",1,0,0,1,2021-11-26
"ASIAN_Andalucia","aimplas",1,0,0,1,2021-11-26
"ASIAN_Andalucia","CoopsAgroAND",1,0,0,1,2021-11-26
"AsocEyC","ACortinaPantion",1,0,0,1,2021-11-26
"AsocEyC","Correos",1,0,0,1,2021-11-26
"AsocEyC","cristinasancho",1,0,0,1,2021-11-26
"AsocEyC","EspejoPublico",1,0,0,1,2021-11-26
"AsocEyC","foroinserta",1,0,0,1,2021-11-26
"AsocEyC","IKEASpain",1,0,0,1,2021-11-26
"asociacionruvid","CienciaGob",1,0,0,1,2021-11-26
"asociacionruvid","ETSEUV",1,0,0,1,2021-11-26
"asociacionruvid","GlobalOmnium",1,0,0,1,2021-11-26
"asociacionruvid","Grupo_CALAGUA",1,0,0,1,2021-11-26
"asociacionruvid","GVAavi",1,0,0,1,2021-11-26
"asociacionruvid","ibv_org",1,0,0,1,2021-11-26
"asociacionruvid","iiama_upv",1,0,0,1,2021-11-26
"asociacionruvid","ITC_ceramica",1,0,0,1,2021-11-26
"Asturicae","aimplas",1,0,0,1,2021-11-26
"Asturicae","geqo_rseq",1,0,0,1,2021-11-26
"Asturicae","inbiotecenlared",1,0,0,1,2021-11-26
"Asturicae","IQAR_UAH",1,0,0,1,2021-11-26
"Asturicae","lualnu10",1,0,0,1,2021-11-26
"Asturicae","UAHes",1,0,0,1,2021-11-26
"atmbiopro","aacudam",1,0,0,1,2021-11-26
"atmbiopro","AgroBioCluster",1,0,0,1,2021-11-26
"atmbiopro","aimplas",1,0,0,1,2021-11-26
"atmbiopro","BBI2020",1,0,0,1,2021-11-26
"atmbiopro","GenHydro",1,0,0,1,2021-11-26
"atmbiopro","GreenovateEU",1,0,0,1,2021-11-26
"atmbiopro","mi_sustainable",1,0,0,1,2021-11-26
"atmbiopro","RISEProcessum",1,0,0,1,2021-11-26
"atmbiopro","tecnopackaging",1,0,0,1,2021-11-26
"atmbiopro","unlock",1,0,0,1,2021-11-26
"auto_revista","aimplas",1,0,0,1,2021-11-26
"auto_revista","auto_revista",0,0,1,1,2021-11-26
"automatica_","Cicloplast_com",1,0,0,1,2021-11-26
"AutPortValencia","aivp_net",1,0,0,1,2021-11-26
"AutPortValencia","aj_gandia",1,0,0,1,2021-11-26
"AutPortValencia","AjuntamentVLC",1,0,0,1,2021-11-26
"AutPortValencia","AsnavieraVlc",1,0,0,1,2021-11-26
"AutPortValencia","ESPOSecretariat",1,0,0,1,2021-11-26
"AutPortValencia","FValenciaport",1,0,0,1,2021-11-26
"AutPortValencia","GVAagroambient",1,0,0,1,2021-11-26
"AutPortValencia","IMOHQ",1,0,0,1,2021-11-26
"AutPortValencia","propellervlc",1,0,0,1,2021-11-26
"AutPortValencia","PuertosEstado",1,0,0,1,2021-11-26
"AutPortValencia","visitgandia",1,0,0,1,2021-11-26
"AVEmpresarios","AIDIMME",1,0,0,1,2021-11-26
"AVEmpresarios","AIJU_Tecnologi",1,0,0,1,2021-11-26
"AVEmpresarios","aimplas",1,0,0,1,2021-11-26
"AVEmpresarios","ainiatecnologia",1,0,0,1,2021-11-26
"AVEmpresarios","aitex_es",1,0,0,1,2021-11-26
"AVEmpresarios","ibv_org",1,0,0,1,2021-11-26
"AVEmpresarios","InescopTech",1,0,0,1,2021-11-26
"AVEmpresarios","ITC_ceramica",1,0,0,1,2021-11-26
"AVEmpresarios","itene",1,0,0,1,2021-11-26
"AVEmpresarios","itenergia",1,0,0,1,2021-11-26
"AVEmpresarios","ITI_TIC",1,0,0,1,2021-11-26
"AVEmpresarios","Saludes_Ind",1,0,0,1,2021-11-26
"AvepAsociacion","AIDIMME",1,0,0,1,2021-11-26
"AvepAsociacion","InescopTech",1,0,0,1,2021-11-26
"AvepAsociacion","PlasticsEurope",1,0,0,1,2021-11-26
"Azmudeu","PRIMAInnovation",1,0,0,1,2021-11-26
"AZoCleantech","aimplas",1,0,0,1,2021-11-26
"baixauli25","aimplas",1,0,0,1,2021-11-26
"baixauli25","idainature",1,0,0,1,2021-11-26
"baixauli25","Novamont",1,0,0,1,2021-11-26
"Baliht_EU","IFBFFlowBattery",1,0,0,1,2021-11-26
"Baliht_EU","JaviPL19",1,0,0,1,2021-11-26
"barana__","aimplas",1,0,0,1,2021-11-26
"bealopezromero","aimplas",1,0,0,1,2021-11-26
"BeonNAT_H2020","ipbragancaEN",1,0,0,1,2021-11-26
"Berto_Jaramillo","aeioLuz",1,0,0,1,2021-11-26
"Berto_Jaramillo","aimplas",1,0,0,1,2021-11-26
"Berto_Jaramillo","alannaasoc",1,0,0,1,2021-11-26
"Berto_Jaramillo","Berto_Jaramillo",0,0,1,1,2021-11-26
"Berto_Jaramillo","BIOagradables",1,0,0,1,2021-11-26
"Berto_Jaramillo","greenurbandata",1,0,0,1,2021-11-26
"Berto_Jaramillo","VortexCoworking",1,0,0,1,2021-11-26
"Berto_Jaramillo","webmesura",1,0,0,1,2021-11-26
"BIGBANInversion","aimplas",1,0,0,1,2021-11-26
"BIGBANInversion","PCientificoAlic",1,0,0,1,2021-11-26
"Bio_Markets","aimplas",1,0,0,1,2021-11-26
"Bio_Markets","BBI2020",1,0,0,1,2021-11-26
"Bio_Markets","Centexbel",1,0,0,1,2021-11-26
"Bio_Markets","CervezaMica",1,0,0,1,2021-11-26
"Bio_Markets","ENCOsrl",1,0,0,1,2021-11-26
"Bio_Markets","EUBioplastics",1,0,0,1,2021-11-26
"Bio_Markets","iris_rd",1,0,0,1,2021-11-26
"Bio_Markets","PlasmaLeapTech",1,0,0,1,2021-11-26
"Bio_Markets","sabiomaterials",1,0,0,1,2021-11-26
"Bio_Markets","SAV_lavega",1,0,0,1,2021-11-26
"BIOnTop_Project","tecnalia",1,0,0,1,2021-11-26
"bioplasticsmag","BIOnTop_Project",1,0,0,1,2021-11-26
"BioSenseRS","aimplas",1,0,0,1,2021-11-26
"BioSenseRS","EU_H2020",1,0,0,1,2021-11-26
"BioSenseRS","GVAivia",1,0,0,1,2021-11-26
"BioSenseRS","Novamont",1,0,0,1,2021-11-26
"BioSenseRS","Terra_i_Xufa",1,0,0,1,2021-11-26
"BioSenseRS","tuc_chania",1,0,0,1,2021-11-26
"BioSenseRS","UA_Universidad",1,0,0,1,2021-11-26
"BIOVAL_es","aitex_es",1,0,0,1,2021-11-26
"BIOVAL_es","cdti",1,0,0,1,2021-11-26
"BIOVAL_es","ceei",1,0,0,1,2021-11-26
"BIOVAL_es","ed_cvalenciana",1,0,0,1,2021-11-26
"BIOVAL_es","SAV_lavega",1,0,0,1,2021-11-26
"BioVale_Cluster","aimplas",1,0,0,1,2021-11-26
"BioVale_Cluster","BBI2020",1,0,0,1,2021-11-26
"BioVale_Cluster","biconsortium",1,0,0,1,2021-11-26
"BioVale_Cluster","biobaseddelta",1,0,0,1,2021-11-26
"BioVale_Cluster","CLIB2021",1,0,0,1,2021-11-26
"BioVale_Cluster","fertinagro",1,0,0,1,2021-11-26
"BioVale_Cluster","IARcluster",1,0,0,1,2021-11-26
"BioVale_Cluster","iris_rd",1,0,0,1,2021-11-26
"BioVale_Cluster","irtacat",1,0,0,1,2021-11-26
"BioVale_Cluster","itene",1,0,0,1,2021-11-26
"BioVale_Cluster","ualmeria",1,0,0,1,2021-11-26
"BioVale_Cluster","Unibo",1,0,0,1,2021-11-26
"BlauBenidorm","Actecosl",1,0,0,1,2021-11-26
"BlauBenidorm","aimplas",1,0,0,1,2021-11-26
"BlueMedEU","ACTeon_Env",1,0,0,1,2021-11-26
"BlueMedEU","CEPESCA",1,0,0,1,2021-11-26
"BlueMedEU","CNRsocial_",1,0,0,1,2021-11-26
"BlueMedEU","EBRD",1,0,0,1,2021-11-26
"BlueMedEU","EU_MARE",1,0,0,1,2021-11-26
"BlueMedEU","EUScienceInnov",1,0,0,1,2021-11-26
"BlueMedEU","FederpescaIT",1,0,0,1,2021-11-26
"BlueMedEU","hcmr_gr",1,0,0,1,2021-11-26
"BlueMedEU","MiTE_IT",1,0,0,1,2021-11-26
"BlueMedEU","OGS_IT",1,0,0,1,2021-11-26
"BlueMedEU","RempecNews",1,0,0,1,2021-11-26
"BlueMedEU","Transport_EU",1,0,0,1,2021-11-26
"BlueMedEU","UN_FAO_GFCM",1,0,0,1,2021-11-26
"BlueMedEU","WorldBank",1,0,0,1,2021-11-26
"byproductplace","aimplas",1,0,0,1,2021-11-26
"byproductplace","byproductplace",0,0,1,1,2021-11-26
"byproductplace","Coexphal",1,0,0,1,2021-11-26
"byproductplace","Grupo_Ence",1,0,0,1,2021-11-26
"byproductplace","LuisMiFedz",1,0,0,1,2021-11-26
"cabocla2001","aimplas",1,0,0,1,2021-11-26
"cabocla2001","BASF_ES",1,0,0,1,2021-11-26
"cabocla2001","deborahciencia",1,0,0,1,2021-11-26
"cabocla2001","PlasticsEuropES",1,0,0,1,2021-11-26
"cabocla2001","Repsol",1,0,0,1,2021-11-26
"cabocla2001","SABIC",1,0,0,1,2021-11-26
"cabocla2001","SusChemSpain",1,0,0,1,2021-11-26
"cadecordobaAE","AceiteOlivalle",1,0,0,1,2021-11-26
"cadecordobaAE","aimplas",1,0,0,1,2021-11-26
"campuscomposits","AEMAC_",1,0,0,1,2021-11-26
"campuscomposits","aernnova_usa",1,0,0,1,2021-11-26
"campuscomposits","aimplas",1,0,0,1,2021-11-26
"campuscomposits","AirbusHeli",1,0,0,1,2021-11-26
"campuscomposits","amade_udg",1,0,0,1,2021-11-26
"carlosgarcia_85","aimplas",1,0,0,1,2021-11-26
"CatedraMare","aimplas",1,0,0,1,2021-11-26
"CBIT_upv","aimplas",1,0,0,1,2021-11-26
"cbm_noticias","AceiteOlivalle",1,0,0,1,2021-11-26
"cbm_noticias","aimplas",1,0,0,1,2021-11-26
"ccasellascoll","aimplas",1,0,0,1,2021-11-26
"ccasellascoll","aitex_es",1,0,0,1,2021-11-26
"ccasellascoll","ClusterFPrint",1,0,0,1,2021-11-26
"ccasellascoll","Eurecat_news",1,0,0,1,2021-11-26
"ccasellascoll","itene",1,0,0,1,2021-11-26
"ccasellascoll","Naitec_CT",1,0,0,1,2021-11-26
"ccasellascoll","PT3NEO",1,0,0,1,2021-11-26
"ccasellascoll","SmartEEsEU",1,0,0,1,2021-11-26
"ccasellascoll","tecnalia",1,0,0,1,2021-11-26
"ccasellascoll","UNavarra",1,0,0,1,2021-11-26
"cdcampo1","AIDIMME",1,0,0,1,2021-11-26
"cdcampo1","AIJU_Tecnologi",1,0,0,1,2021-11-26
"cdcampo1","ainiatecnologia",1,0,0,1,2021-11-26
"cdcampo1","aitex_es",1,0,0,1,2021-11-26
"cdcampo1","Aranviyu",1,0,0,1,2021-11-26
"cdcampo1","BVilata",1,0,0,1,2021-11-26
"cdcampo1","Fedit",1,0,0,1,2021-11-26
"cdcampo1","GVAavi",1,0,0,1,2021-11-26
"cdcampo1","GVAinnova",1,0,0,1,2021-11-26
"cdcampo1","GVAivace",1,0,0,1,2021-11-26
"cdcampo1","ibv_org",1,0,0,1,2021-11-26
"cdcampo1","InescopTech",1,0,0,1,2021-11-26
"cdcampo1","ITC_ceramica",1,0,0,1,2021-11-26
"cdcampo1","itene",1,0,0,1,2021-11-26
"cdcampo1","itenergia",1,0,0,1,2021-11-26
"cdcampo1","ITI_TIC",1,0,0,1,2021-11-26
"cdcampo1","OCRValencia",1,0,0,1,2021-11-26
"cdcampo1","palbeme",1,0,0,1,2021-11-26
"cdcampo1","teatroolympia",1,0,0,1,2021-11-26
"CdeCarnica","Agroforest_JAL",1,0,0,1,2021-11-26
"CdeCarnica","BetoELescamoso",1,0,0,1,2021-11-26
"CdeCarnica","Certicar_",1,0,0,1,2021-11-26
"CdeCarnica","CoralCarrasco4",1,0,0,1,2021-11-26
"CdeCarnica","elhordoy_luis",1,0,0,1,2021-11-26
"CdeCarnica","GSCSAL",1,0,0,1,2021-11-26
"CdeCarnica","jhaa2020",1,0,0,1,2021-11-26
"CdeCarnica","juancfa16",1,0,0,1,2021-11-26
"CdeCarnica","LaComarcaMeats",1,0,0,1,2021-11-26
"CdeCarnica","Lumeoh",1,0,0,1,2021-11-26
"CdeCarnica","osayagues",1,0,0,1,2021-11-26
"CdeCarnica","rami44618546",1,0,0,1,2021-11-26
"ceeivalencia","AIJU_Tecnologi",1,0,0,1,2021-11-26
"ceeivalencia","caterina_coll",1,0,0,1,2021-11-26
"ceeivalencia","DarwinBioprosp",1,0,0,1,2021-11-26
"ceeivalencia","ibv_org",1,0,0,1,2021-11-26
"ceeivalencia","ITC_ceramica",1,0,0,1,2021-11-26
"ceeivalencia","ITI_TIC",1,0,0,1,2021-11-26
"ceeivalencia","Julia_company",1,0,0,1,2021-11-26
"ceeivalencia","rafacliment_",1,0,0,1,2021-11-26
"ceeivalencia","Rebeca_Torro",1,0,0,1,2021-11-26
"CEPplast","3Dnatives_ES",1,0,0,1,2021-11-26
"CEPplast","AEBALL_UPMBALL",1,0,0,1,2021-11-26
"CEPplast","AEMAC_",1,0,0,1,2021-11-26
"CEPplast","AerAutomation",1,0,0,1,2021-11-26
"CEPplast","aiasasociacion",1,0,0,1,2021-11-26
"CEPplast","ANARPLA",1,0,0,1,2021-11-26
"CEPplast","ascameorg",1,0,0,1,2021-11-26
"CEPplast","camarascomercio",1,0,0,1,2021-11-26
"CEPplast","cambrabcn",1,0,0,1,2021-11-26
"CEPplast","ClubMktBcn",1,0,0,1,2021-11-26
"CEPplast","ClusterCICAT",1,0,0,1,2021-11-26
"CEPplast","Digicomexpo",1,0,0,1,2021-11-26
"CEPplast","elpublicistacom",1,0,0,1,2021-11-26
"CEPplast","Envaspres",1,0,0,1,2021-11-26
"CEPplast","eoi",1,0,0,1,2021-11-26
"CEPplast","Eurecat_news",1,0,0,1,2021-11-26
"CEPplast","HispaRob",1,0,0,1,2021-11-26
"CEPplast","industrialesand",1,0,0,1,2021-11-26
"CEPplast","innovallcluster",1,0,0,1,2021-11-26
"CEPplast","int_envase",1,0,0,1,2021-11-26
"CEPplast","IPMARK",1,0,0,1,2021-11-26
"CEPplast","itene",1,0,0,1,2021-11-26
"CEPplast","mincoturgob",1,0,0,1,2021-11-26
"CEPplast","packcluster",1,0,0,1,2021-11-26
"CEPplast","PatronalCecot",1,0,0,1,2021-11-26
"CEPplast","RevistaInfopack",1,0,0,1,2021-11-26
"CEPplast","SECARTYS",1,0,0,1,2021-11-26
"CetecCentro","aimplas",1,0,0,1,2021-11-26
"CetecCentro","ANAIP_es",1,0,0,1,2021-11-26
"chemplastexpo","aimplas",1,0,0,1,2021-11-26
"ChemRecycleNews","aimplas",1,0,0,1,2021-11-26
"Cicloplast_com","ANAIP_es",1,0,0,1,2021-11-26
"Cicloplast_com","FuturEnviro",0,1,0,1,2021-11-26
"ciconiaeduca","AceiteOlivalle",1,0,0,1,2021-11-26
"ciconiaeduca","aimplas",1,0,0,1,2021-11-26
"CIDETEC_","aimplas",1,0,0,1,2021-11-26
"CIMPA_Project","aimplas",1,0,0,1,2021-11-26
"CIMPA_Project","CT_IPC",1,0,0,1,2021-11-26
"CIMPA_Project","EuRIC_Recycling",1,0,0,1,2021-11-26
"CIMPA_Project","TNO_Research",1,0,0,1,2021-11-26
"CIMPA_Project","VTTFinland",1,0,0,1,2021-11-26
"cinea_eu","aqua_lit",1,0,0,1,2021-11-26
"cinea_eu","CiimarUp",1,0,0,1,2021-11-26
"cinea_eu","cinea_eu",0,0,1,1,2021-11-26
"cinea_eu","GeoEnvTech",1,0,0,1,2021-11-26
"cinea_eu","marGnetproject",1,0,0,1,2021-11-26
"cinea_eu","NetTagProject",1,0,0,1,2021-11-26
"Circulariana","aimplas",1,0,0,1,2021-11-26
"Circulariana","stanpa_es",1,0,0,1,2021-11-26
"Club_Excelencia","ColegioSalliver",1,0,0,1,2021-11-26
"Club_Excelencia","GrupoSorollaEdu",1,0,0,1,2021-11-26
"clubcalidadcom","aimplas",1,0,0,1,2021-11-26
"clubcalidadcom","CentrosCex",1,0,0,1,2021-11-26
"clubcalidadcom","corifyAF",1,0,0,1,2021-11-26
"clubcalidadcom","Grupo_TSK",1,0,0,1,2021-11-26
"clubcalidadcom","Molecor",1,0,0,1,2021-11-26
"clubcalidadcom","PigCHAMP_Europa",1,0,0,1,2021-11-26
"clubcalidadcom","PlatinoEduca",1,0,0,1,2021-11-26
"clubcalidadcom","skrollerbelt",1,0,0,1,2021-11-26
"clusaga","aimplas",1,0,0,1,2021-11-26
"clusaga","ainiatecnologia",1,0,0,1,2021-11-26
"ClusterFPrint","CienciaGob",1,0,0,1,2021-11-26
"ClusterFPrint","ClusterFPrint",1,0,0,1,2021-11-26
"ClusterFPrint","Eurecat_news",1,0,0,1,2021-11-26
"ClusterFPrint","itene",1,0,0,1,2021-11-26
"CMplastik","aimplas",1,0,0,1,2021-11-26
"COEXPAN_","ainiatecnologia",1,0,0,1,2021-11-26
"COEXPAN_","Cicloplast_com",1,0,0,1,2021-11-26
"COGITIValencia","GVAeconomia",1,0,0,1,2021-11-26
"COGITIValencia","GVAivace",1,0,0,1,2021-11-26
"COIQCV","aimplas",1,0,0,1,2021-11-26
"Colquimva","aimplas",1,0,0,1,2021-11-26
"ConsejoAgricola","aimplas",1,0,0,1,2021-11-26
"convertronic","aimplas",1,0,0,1,2021-11-26
"CoopsAgroCV","CoopsAgroCV",0,0,1,1,2021-11-26
"COPEPozoblanco","AceiteOlivalle",1,0,0,1,2021-11-26
"COPEPozoblanco","aimplas",1,0,0,1,2021-11-26
"COPEPozoblanco","CECOes_",1,0,0,1,2021-11-26
"coplasem","aimplas",1,0,0,1,2021-11-26
"Corresponsables","Corresponsables",0,0,1,1,2021-11-26
"CosmeticLatam","CosmeticLatam",0,0,1,1,2021-11-26
"CozAlberto","aimplas",1,0,0,1,2021-11-26
"CRIBE_Biomass","aimplas",1,0,0,1,2021-11-26
"CRIBE_Biomass","TNO_Research",1,0,0,1,2021-11-26
"Crowdhelix","iris_rd",1,0,0,1,2021-11-26
"Crowdhelix","MulticycleP",1,0,0,1,2021-11-26
"CServees","aimplas",1,0,0,1,2021-11-26
"CServees","LinkedIn",1,0,0,1,2021-11-26
"CticCita","aimplas",1,0,0,1,2021-11-26
"CticCita","launioncorp",1,0,0,1,2021-11-26
"CVI_V3","aimplas",1,0,0,1,2021-11-26
"CVI_V3","CORDIS_EU",1,0,0,1,2021-11-26
"CVI_V3","URBANREC_H2020",1,0,0,1,2021-11-26
"DarwinBioprosp","i2sysbio",1,0,0,1,2021-11-26
"davidorreta","Cicloplast_com",1,0,0,1,2021-11-26
"davidorreta","ITC_ceramica",1,0,0,1,2021-11-26
"davidorreta","UV_EG",1,0,0,1,2021-11-26
"deborahciencia","aimplas",1,0,0,1,2021-11-26
"deborahciencia","BASF_ES",1,0,0,1,2021-11-26
"deborahciencia","PlasticsEuropES",1,0,0,1,2021-11-26
"deborahciencia","Repsol",1,0,0,1,2021-11-26
"deborahciencia","SABIC",1,0,0,1,2021-11-26
"detectormadrid","aimplas",1,0,0,1,2021-11-26
"DGreenblogger","BIOnTop_Project",1,0,0,1,2021-11-26
"DigitalEscudo","aimplas",1,0,0,1,2021-11-26
"DigitalEscudo","GVAivace",1,0,0,1,2021-11-26
"DigitalEscudo","ITI_TIC",1,0,0,1,2021-11-26
"dipMurcia","aimplas",1,0,0,1,2021-11-26
"dipMurcia","artsolut",1,0,0,1,2021-11-26
"dipMurcia","EssentraPackES",1,0,0,1,2021-11-26
"dipMurcia","Foro_READ",1,0,0,1,2021-11-26
"dipMurcia","itene",1,0,0,1,2021-11-26
"dipMurcia","Packnet_",1,0,0,1,2021-11-26
"DominoPrint_ES","ANAIP_es",1,0,0,1,2021-11-26
"DominoPrint_ES","Cicloplast_com",1,0,0,1,2021-11-26
"DominoPrint_ES","esplasticos",1,0,0,1,2021-11-26
"DominoPrint_ES","PlasticsEurope",1,0,0,1,2021-11-26
"DominoPrint_Mx","esplasticos",1,0,0,1,2021-11-26
"DominoPrint_Mx","plastic_museum",1,0,0,1,2021-11-26
"DominoPrint_Mx","RPM_Plasticos",1,0,0,1,2021-11-26
"DriadeSM","aimplas",1,0,0,1,2021-11-26
"DriadeSM","f_f_ambiental",1,0,0,1,2021-11-26
"DriadeSM","Suruscircular",1,0,0,1,2021-11-26
"DulcesNoticias","ainiatecnologia",1,0,0,1,2021-11-26
"DulcesNoticias","ANAIP_es",1,0,0,1,2021-11-26
"DulcesNoticias","ANARPLA",1,0,0,1,2021-11-26
"DulcesNoticias","danone_es",1,0,0,1,2021-11-26
"DulcesNoticias","faerchgroup",1,0,0,1,2021-11-26
"DulcesNoticias","Nestle_es",1,0,0,1,2021-11-26
"DulcesNoticias","UV_EG",1,0,0,1,2021-11-26
"ECAndalucia","20m",1,0,0,1,2021-11-26
"ECCA_Sevilla","ACCIONA",1,0,0,1,2021-11-26
"ECCA_Sevilla","aimplas",1,0,0,1,2021-11-26
"ECCA_Sevilla","ECCA_Sevilla",0,1,0,1,2021-11-26
"ECCA_Sevilla","FundacionRepsol",1,0,0,1,2021-11-26
"ECCA_Sevilla","knaufes",1,0,0,1,2021-11-26
"ECCA_Sevilla","WTS_Horizon",1,0,0,1,2021-11-26
"EcoconstruMag","AIDIMME",1,0,0,1,2021-11-26
"EcoconstruMag","ITCCANARIAS",1,0,0,1,2021-11-26
"ecoefishent","aimplas",1,0,0,1,2021-11-26
"ecoefishent","Amp_Portofino",1,0,0,1,2021-11-26
"ecoefishent","ARPALiguria",1,0,0,1,2021-11-26
"ecoefishent","cibmlivorno",1,0,0,1,2021-11-26
"ecoefishent","CProplast",1,0,0,1,2021-11-26
"ecoefishent","ItalyFoodTrade",1,0,0,1,2021-11-26
"ecoefishent","Pouvoirdesidees",1,0,0,1,2021-11-26
"ecoefishent","Ticass2012",1,0,0,1,2021-11-26
"ecoefishent","ubarilan",1,0,0,1,2021-11-26
"ecoefishent","WWFitalia",1,0,0,1,2021-11-26
"Economia_3","ana_gil_lop",1,0,0,1,2021-11-26
"Economia_3","ANAIP_es",1,0,0,1,2021-11-26
"Economia_3","AvepAsociacion",1,0,0,1,2021-11-26
"Economia_3","GVAavi",1,0,0,1,2021-11-26
"Economia_3","IISLaFe",1,0,0,1,2021-11-26
"Economia_3","Industrias_TAYG",1,0,0,1,2021-11-26
"Economia_3","itmupv",1,0,0,1,2021-11-26
"Economia_3","ITQ_UPVCSIC",1,0,0,1,2021-11-26
"EcoxyProject","Avantium",1,0,0,1,2021-11-26
"EcoxyProject","BBI2020",1,0,0,1,2021-11-26
"EcoxyProject","Centexbel",1,0,0,1,2021-11-26
"EcoxyProject","CIDETEC_",1,0,0,1,2021-11-26
"EcoxyProject","crfiat",1,0,0,1,2021-11-26
"EcoxyProject","EcoxyProject",0,0,1,1,2021-11-26
"EcoxyProject","FraunhoferICT",1,0,0,1,2021-11-26
"EcoxyProject","SP_Polymers",1,0,0,1,2021-11-26
"ed_cvalenciana","aimplas",1,0,0,1,2021-11-26
"ed_cvalenciana","BIOVAL_es",1,0,0,1,2021-11-26
"ed_cvalenciana","carlosidai",1,0,0,1,2021-11-26
"ed_cvalenciana","ceeivalencia",1,0,0,1,2021-11-26
"ed_cvalenciana","emprenemjunts",1,0,0,1,2021-11-26
"ed_cvalenciana","itenergia",1,0,0,1,2021-11-26
"EDICIONESSIBILA","AIJU_Tecnologi",1,0,0,1,2021-11-26
"EDICIONESSIBILA","aitex_es",1,0,0,1,2021-11-26
"EDICIONESSIBILA","generalitat",1,0,0,1,2021-11-26
"EDICIONESSIBILA","GVAivace",1,0,0,1,2021-11-26
"EDICIONESSIBILA","GVAlabora",1,0,0,1,2021-11-26
"EditaOla","aimplas",1,0,0,1,2021-11-26
"EditaOla","Arturolarena",1,0,0,1,2021-11-26
"EditaOla","BelenFranch",1,0,0,1,2021-11-26
"edpemo","aimplas",1,0,0,1,2021-11-26
"edpemo","AvepAsociacion",1,0,0,1,2021-11-26
"edpemo","Avia_automocion",1,0,0,1,2021-11-26
"edpemo","CEPplast",1,0,0,1,2021-11-26
"edpemo","HP",1,0,0,1,2021-11-26
"edpemo","IAM3DHUB",1,0,0,1,2021-11-26
"edpemo","industry_arena",1,0,0,1,2021-11-26
"edpemo","PlasticsEuropES",1,0,0,1,2021-11-26
"Educanced","aimplas",1,0,0,1,2021-11-26
"EduTorregrosa12","aimplas",1,0,0,1,2021-11-26
"EduTorregrosa12","corifyAF",1,0,0,1,2021-11-26
"EduTorregrosa12","Grupo_TSK",1,0,0,1,2021-11-26
"EduTorregrosa12","Molecor",1,0,0,1,2021-11-26
"EduTorregrosa12","PigCHAMP_Europa",1,0,0,1,2021-11-26
"EduTorregrosa12","PlatinoEduca",1,0,0,1,2021-11-26
"EEljarrat","aimplas",1,0,0,1,2021-11-26
"EFE_CValenciana","ainiatecnologia",1,0,0,1,2021-11-26
"EFE_CValenciana","itenergia",1,0,0,1,2021-11-26
"EFE_CValenciana","Redit_es",1,0,0,1,2021-11-26
"Efeagro","aimplas",1,0,0,1,2021-11-26
"Efeagro","idainature",1,0,0,1,2021-11-26
"EFEcomunica","itenergia",1,0,0,1,2021-11-26
"EIPAGRI_SP","AceiteOlivalle",1,0,0,1,2021-11-26
"EIPAGRI_SP","aimplas",1,0,0,1,2021-11-26
"eldiarioclm","aimplas",1,0,0,1,2021-11-26
"eldiarioclm","inbiotecenlared",1,0,0,1,2021-11-26
"eldiarioclm","MartaEGMosquera",1,0,0,1,2021-11-26
"eldiarioclm","UAHes",1,0,0,1,2021-11-26
"elEconomistaCV","ainiatecnologia",1,0,0,1,2021-11-26
"ElQuincenal","AceiteOlivalle",1,0,0,1,2021-11-26
"ElQuincenal","aimplas",1,0,0,1,2021-11-26
"EmballagesMag","aimplas",1,0,0,1,2021-11-26
"EmballagesMag","CT_IPC",1,0,0,1,2021-11-26
"EmballagesMag","Leygatech1",1,0,0,1,2021-11-26
"EmballagesMag","Paprec_Group",1,0,0,1,2021-11-26
"EmballagesMag","pellencst",1,0,0,1,2021-11-26
"EmballagesMag","VTTFinland",1,0,0,1,2021-11-26
"emprenemjunts","aganovagrupo",1,0,0,1,2021-11-26
"emprenemjunts","Betelgeux_es",1,0,0,1,2021-11-26
"emprenemjunts","ceei",1,0,0,1,2021-11-26
"emprenemjunts","EosOrbital",1,0,0,1,2021-11-26
"emprenemjunts","FEDACOVA_VLC",1,0,0,1,2021-11-26
"emprenemjunts","fundeun",1,0,0,1,2021-11-26
"emprenemjunts","GlobalOmnium",1,0,0,1,2021-11-26
"emprenemjunts","GoHubTech",1,0,0,1,2021-11-26
"emprenemjunts","GVAavi",1,0,0,1,2021-11-26
"emprenemjunts","GVAddigital",1,0,0,1,2021-11-26
"emprenemjunts","iata_csic",1,0,0,1,2021-11-26
"emprenemjunts","LasNavesINN",1,0,0,1,2021-11-26
"emprenemjunts","lasprovincias",1,0,0,1,2021-11-26
"emprenemjunts","LinkenerSpain",1,0,0,1,2021-11-26
"emprenemjunts","parccientificuv",1,0,0,1,2021-11-26
"emprenemjunts","Periodistas360",1,0,0,1,2021-11-26
"emprenemjunts","sistema_doeet",1,0,0,1,2021-11-26
"emprenemjunts","UV_EG",1,0,0,1,2021-11-26
"emprenemjunts","valgenetics",1,0,0,1,2021-11-26
"EMSUR_","aimplas",1,0,0,1,2021-11-26
"EMSUR_","EMSUR_",1,0,0,1,2021-11-26
"entidadPTV","SagredoMarco",0,1,0,1,2021-11-26
"EPCValenciana","aimplas",1,0,0,1,2021-11-26
"EPCValenciana","GVAivace",1,0,0,1,2021-11-26
"EPPM_Magazine","BerryGlobalInc",1,0,0,1,2021-11-26
"EPPM_Magazine","breathe_99",1,0,0,1,2021-11-26
"EPPM_Magazine","CarmofProject",1,0,0,1,2021-11-26
"EPPM_Magazine","InterplasUK",1,0,0,1,2021-11-26
"EPPM_Magazine","kpGroup_",1,0,0,1,2021-11-26
"EPPM_Magazine","LeistritzCorp",1,0,0,1,2021-11-26
"EPPM_Magazine","SABIC",1,0,0,1,2021-11-26
"EPPM_Magazine","TiniusOlsen1",1,0,0,1,2021-11-26
"EPPM_Magazine","TNO_Research",1,0,0,1,2021-11-26
"EPPM_Magazine","TOMRAGroup",1,0,0,1,2021-11-26
"Equiplast","AMETIC_es",1,0,0,1,2021-11-26
"Equiplast","Ascamm_Gremi",1,0,0,1,2021-11-26
"Equiplast","asegre01",1,0,0,1,2021-11-26
"Equiplast","BASF_ES",1,0,0,1,2021-11-26
"Equiplast","CEP",1,0,0,1,2021-11-26
"Equiplast","CEPplast",1,0,0,1,2021-11-26
"Equiplast","CienciaGob",1,0,0,1,2021-11-26
"Equiplast","circ_economy",1,0,0,1,2021-11-26
"Equiplast","deborahciencia",1,0,0,1,2021-11-26
"Equiplast","eRecicla",1,0,0,1,2021-11-26
"Equiplast","FidaMc",1,0,0,1,2021-11-26
"Equiplast","mincoturgob",1,0,0,1,2021-11-26
"Equiplast","mitecogob",1,0,0,1,2021-11-26
"Equiplast","PT3NEO",1,0,0,1,2021-11-26
"Equiplast","Repsol",1,0,0,1,2021-11-26
"Equiplast","SABIC",1,0,0,1,2021-11-26
"Equiplast","SusChemSpain",1,0,0,1,2021-11-26
"espaitec","aimplas",1,0,0,1,2021-11-26
"espaitec","innotransfer",1,0,0,1,2021-11-26
"esplasticos","20m",1,0,0,1,2021-11-26
"esplasticos","ANAIP_es",1,0,0,1,2021-11-26
"esplasticos","ANARPLA",1,0,0,1,2021-11-26
"esplasticos","AvepAsociacion",1,0,0,1,2021-11-26
"esplasticos","PlasticsEuropES",1,0,0,1,2021-11-26
"esplasticos","TeknikerOficial",1,0,0,1,2021-11-26
"esquerrapv","aimplas",1,0,0,1,2021-11-26
"esquerrapv","gbelenguer",1,0,0,1,2021-11-26
"esquerrapv","Redit_es",1,0,0,1,2021-11-26
"esquerrapv","Sebastia_Jordi",1,0,0,1,2021-11-26
"Eternal_Energy_","aimplas",1,0,0,1,2021-11-26
"Eternal_Energy_","itenergia",1,0,0,1,2021-11-26
"Eternal_Energy_","Per_Energia",1,0,0,1,2021-11-26
"ETSEUV","aimplas",1,0,0,1,2021-11-26
"ETSEUV","ETSEUV",0,0,1,1,2021-11-26
"ETSEUV","GlobalOmnium",1,0,0,1,2021-11-26
"ETSEUV","Grupo_CALAGUA",1,0,0,1,2021-11-26
"EUBioplastics","BBI2020",1,0,0,1,2021-11-26
"EUBioplastics","BIOnTop_Project",1,0,0,1,2021-11-26
"EUBioplastics","EU_H2020",1,0,0,1,2021-11-26
"EUBioplastics","OceanetsProject",1,0,0,1,2021-11-26
"EURO_FUNDING","aimplas",1,0,0,1,2021-11-26
"eurocarne","ANAIP_es",1,0,0,1,2021-11-26
"eurocarne","PlasticsEuropES",1,0,0,1,2021-11-26
"Eurofach","aimplas",1,0,0,1,2021-11-26
"Eurosurfas","AMETIC_es",1,0,0,1,2021-11-26
"Eurosurfas","asegre01",1,0,0,1,2021-11-26
"Eurosurfas","FidaMc",1,0,0,1,2021-11-26
"Eurosurfas","PT3NEO",1,0,0,1,2021-11-26
"Eurosurfas","tecnalia",1,0,0,1,2021-11-26
"evaquie","aimplas",1,0,0,1,2021-11-26
"evaquie","rodysuarez",1,0,0,1,2021-11-26
"excedentesolar","aimplas",1,0,0,1,2021-11-26
"excedentesolar","BASF_ES",1,0,0,1,2021-11-26
"excedentesolar","deborahciencia",1,0,0,1,2021-11-26
"excedentesolar","PlasticsEuropES",1,0,0,1,2021-11-26
"excedentesolar","Repsol",1,0,0,1,2021-11-26
"excedentesolar","SABIC",1,0,0,1,2021-11-26
"excedentesolar","SusChemSpain",1,0,0,1,2021-11-26
"expoquimia","AMETIC_es",1,0,0,1,2021-11-26
"expoquimia","asegre01",1,0,0,1,2021-11-26
"expoquimia","BASF_ES",1,0,0,1,2021-11-26
"expoquimia","deborahciencia",1,0,0,1,2021-11-26
"expoquimia","FidaMc",1,0,0,1,2021-11-26
"expoquimia","PlasticsEuropES",1,0,0,1,2021-11-26
"expoquimia","PT3NEO",1,0,0,1,2021-11-26
"expoquimia","Repsol",1,0,0,1,2021-11-26
"expoquimia","SABIC",1,0,0,1,2021-11-26
"expoquimia","SusChemSpain",1,0,0,1,2021-11-26
"expoquimia","tecnalia",1,0,0,1,2021-11-26
"EySMunicipales","aimplas",1,0,0,1,2021-11-26
"FabricaPodcast","AIDIMME",1,0,0,1,2021-11-26
"FabricaPodcast","AIJU_Tecnologi",1,0,0,1,2021-11-26
"FabricaPodcast","aimplas",1,0,0,1,2021-11-26
"FabricaPodcast","ainiatecnologia",1,0,0,1,2021-11-26
"FabricaPodcast","aitex_es",1,0,0,1,2021-11-26
"FabricaPodcast","ibv_org",1,0,0,1,2021-11-26
"FabricaPodcast","InescopTech",1,0,0,1,2021-11-26
"FabricaPodcast","itene",1,0,0,1,2021-11-26
"FabricaPodcast","ITI_TIC",1,0,0,1,2021-11-26
"FabricaPodcast","Redit_es",1,0,0,1,2021-11-26
"fadiplastsl","AIDIMME",1,0,0,1,2021-11-26
"fadiplastsl","InescopTech",1,0,0,1,2021-11-26
"FarrellyMitchel","aacudam",1,0,0,1,2021-11-26
"FarrellyMitchel","AgroBioCluster",1,0,0,1,2021-11-26
"FarrellyMitchel","aimplas",1,0,0,1,2021-11-26
"FarrellyMitchel","CIDETEC_",1,0,0,1,2021-11-26
"FarrellyMitchel","FarrellyMitchel",0,1,0,1,2021-11-26
"FarrellyMitchel","GenHydro",1,0,0,1,2021-11-26
"FarrellyMitchel","GreenovateEU",1,0,0,1,2021-11-26
"FarrellyMitchel","mi_sustainable",1,0,0,1,2021-11-26
"FarrellyMitchel","RISEProcessum",1,0,0,1,2021-11-26
"FCalidad","GVAavi",1,0,0,1,2021-11-26
"FCalidad","IISLaFe",1,0,0,1,2021-11-26
"FCalidad","Industrias_TAYG",1,0,0,1,2021-11-26
"FCalidad","itmupv",1,0,0,1,2021-11-26
"FCalidad","tecnalia",1,0,0,1,2021-11-26
"FConexus","aimplas",1,0,0,1,2021-11-26
"FEDACOVA_VLC","aimplas",1,0,0,1,2021-11-26
"FEDACOVA_VLC","ainiatecnologia",1,0,0,1,2021-11-26
"Fedit","zeus_packaging",1,0,0,1,2021-11-26
"Feique_ES","aimplas",1,0,0,1,2021-11-26
"Feique_ES","BASF_ES",1,0,0,1,2021-11-26
"Feique_ES","deborahciencia",1,0,0,1,2021-11-26
"Feique_ES","PlasticsEuropES",1,0,0,1,2021-11-26
"Feique_ES","Repsol",1,0,0,1,2021-11-26
"Feique_ES","SABIC",1,0,0,1,2021-11-26
"Feique_ES","SusChemSpain",1,0,0,1,2021-11-26
"Ferfollos","aimplas",1,0,0,1,2021-11-26
"feriaecofira","ecoticiasRED",1,0,0,1,2021-11-26
"feriaecofira","GVAivace",1,0,0,1,2021-11-26
"feriaecofira","UV_EG",1,0,0,1,2021-11-26
"Fernando_Ca_63","AIDIMME",1,0,0,1,2021-11-26
"Fernando_Ca_63","entidadPTV",1,0,0,1,2021-11-26
"Fernando_Ca_63","InescopTech",1,0,0,1,2021-11-26
"fertinagro","aimplas",1,0,0,1,2021-11-26
"Fesord","aimplas",1,0,0,1,2021-11-26
"ffe_es","Adif_es",1,0,0,1,2021-11-26
"ffe_es","AgEInves",1,0,0,1,2021-11-26
"ffe_es","ArcelorMittal",1,0,0,1,2021-11-26
"ffe_es","La_UPM",1,0,0,1,2021-11-26
"ffe_es","mitmagob",1,0,0,1,2021-11-26
"ffe_es","Shift2Rail_JU",1,0,0,1,2021-11-26
"ffe_es","TalgoGroup",1,0,0,1,2021-11-26
"ffe_es","tecnalia",1,0,0,1,2021-11-26
"fgirona","aimplas",1,0,0,1,2021-11-26
"fgirona","Benihort",1,0,0,1,2021-11-26
"fgirona","CoopsAgroCV",1,0,0,1,2021-11-26
"fgirona","GVAavi",1,0,0,1,2021-11-26
"fgirona","IBMCP",1,0,0,1,2021-11-26
"FGlobalis","ajvila",1,0,0,1,2021-11-26
"FGlobalis","CDTIoficial",1,0,0,1,2021-11-26
"FGlobalis","dipcas",1,0,0,1,2021-11-26
"FIDAMC_","AEMAC_",1,0,0,1,2021-11-26
"FIDAMC_","Eurecat_news",1,0,0,1,2021-11-26
"FIDAMC_","FIDAMC_",0,1,0,1,2021-11-26
"FIDAMC_","Fira_Barcelona",1,0,0,1,2021-11-26
"fihguv","GVAsanitat",1,0,0,1,2021-11-26
"fihguv","HGUVALENCIA",0,1,0,1,2021-11-26
"fihguv","IRTIC_UV",1,0,0,1,2021-11-26
"fihguv","UPV",1,0,0,1,2021-11-26
"FlotantProject","FutureFibres",1,0,0,1,2021-11-26
"FlotantProject","GranCanariaCab",1,0,0,1,2021-11-26
"FlotantProject","Renewables_UoE",1,0,0,1,2021-11-26
"FlotantProject","RWTH",1,0,0,1,2021-11-26
"FlotantProject","TfiMarine",1,0,0,1,2021-11-26
"food_retail","esplasticos",1,0,0,1,2021-11-26
"Food4LifeSPAIN","CticCita",1,0,0,1,2021-11-26
"Food4LifeSPAIN","PKF_INNCOME",1,0,0,1,2021-11-26
"Food4LifeSPAIN","Sealed_Air",1,0,0,1,2021-11-26
"Food4LifeSPAIN","UABBarcelona",1,0,0,1,2021-11-26
"FoodTechBiz","aimplas",1,0,0,1,2021-11-26
"ForoQyS","Airbus",1,0,0,1,2021-11-26
"ForoQyS","Cefic",1,0,0,1,2021-11-26
"ForoQyS","deborahciencia",1,0,0,1,2021-11-26
"ForoQyS","foretica",1,0,0,1,2021-11-26
"ForoQyS","GVAivace",1,0,0,1,2021-11-26
"ForoQyS","Pascual",1,0,0,1,2021-11-26
"ForoQyS","ternua",1,0,0,1,2021-11-26
"ForoQyS","UPV",1,0,0,1,2021-11-26
"FranoisStryker1","AErasmusproject",0,1,0,1,2021-11-26
"FranoisStryker1","aimplas",1,0,0,1,2021-11-26
"FranoisStryker1","Jobsatskills",1,0,0,1,2021-11-26
"fruittoday","ADNAgroFood",1,0,0,1,2021-11-26
"fruittoday","Cajamar",1,0,0,1,2021-11-26
"fruittoday","esplasticos",1,0,0,1,2021-11-26
"fruittoday","frutasloscursos",1,0,0,1,2021-11-26
"fruittoday","fTROPS",1,0,0,1,2021-11-26
"fruittoday","launioncorp",1,0,0,1,2021-11-26
"fruittoday","mitecogob",1,0,0,1,2021-11-26
"fruittoday","RG_tropical",1,0,0,1,2021-11-26
"Fryjole","aimplas",1,0,0,1,2021-11-26
"Fryjole","AMIQGreenChem",1,0,0,1,2021-11-26
"Fryjole","AseBio",1,0,0,1,2021-11-26
"Fryjole","AVEBIOM",1,0,0,1,2021-11-26
"Fryjole","bioplat",1,0,0,1,2021-11-26
"Fryjole","CienciaGob",1,0,0,1,2021-11-26
"Fryjole","FEBiotec",1,0,0,1,2021-11-26
"Fryjole","SusChemSpain",1,0,0,1,2021-11-26
"Fund_Diversidad","EU_Commission",1,0,0,1,2021-11-26
"Fund_Diversidad","EU_Justice",1,0,0,1,2021-11-26
"Fund_Diversidad","helenadalli",1,0,0,1,2021-11-26
"FundacionECOTIC","aimplas",1,0,0,1,2021-11-26
"FuturEnviro","aebigspain",1,0,0,1,2021-11-26
"FuturEnviro","AIDIMME",1,0,0,1,2021-11-26
"FuturEnviro","airesaslu",1,0,0,1,2021-11-26
"FuturEnviro","aitiip",1,0,0,1,2021-11-26
"FuturEnviro","ANAIP_es",1,0,0,1,2021-11-26
"FuturEnviro","aqualia",1,0,0,1,2021-11-26
"FuturEnviro","AvepAsociacion",1,0,0,1,2021-11-26
"FuturEnviro","BASF_ES",1,0,0,1,2021-11-26
"FuturEnviro","CIDETEC_",1,0,0,1,2021-11-26
"FuturEnviro","ecodigestion",1,0,0,1,2021-11-26
"FuturEnviro","esplasticos",1,0,0,1,2021-11-26
"FuturEnviro","EU_ENV",1,0,0,1,2021-11-26
"FuturEnviro","eucobat",1,0,0,1,2021-11-26
"FuturEnviro","FCC_MA",1,0,0,1,2021-11-26
"FuturEnviro","fempcomunica",1,0,0,1,2021-11-26
"FuturEnviro","InescopTech",1,0,0,1,2021-11-26
"FuturEnviro","ITC_ceramica",1,0,0,1,2021-11-26
"FuturEnviro","Molecor",1,0,0,1,2021-11-26
"FuturEnviro","OHBasanta",1,0,0,1,2021-11-26
"FuturEnviro","paperChain_pro",1,0,0,1,2021-11-26
"FuturEnviro","picvisa",1,0,0,1,2021-11-26
"FuturEnviro","PlasticsEuropES",1,0,0,1,2021-11-26
"FuturEnviro","PTARElSalitre",1,0,0,1,2021-11-26
"FuturEnviro","recyclia",1,0,0,1,2021-11-26
"FuturEnviro","Repsol",1,0,0,1,2021-11-26
"FuturEnviro","suezES",1,0,0,1,2021-11-26
"FuturEnviro","TNO_Research",1,0,0,1,2021-11-26
"FuturEnviro","UV_EG",1,0,0,1,2021-11-26
"FValenciaport","aimplas",1,0,0,1,2021-11-26
"gacetadental","aimplas",1,0,0,1,2021-11-26
"gacetadental","ibv_org",1,0,0,1,2021-11-26
"GAIKER_BRTA","aimplas",1,0,0,1,2021-11-26
"GAIKER_BRTA","aitex_es",1,0,0,1,2021-11-26
"GAIKER_BRTA","CDTIoficial",1,0,0,1,2021-11-26
"GAIKER_BRTA","Cidaut",1,0,0,1,2021-11-26
"garcia_saludes","AIDIMME",1,0,0,1,2021-11-26
"garcia_saludes","AIJU_Tecnologi",1,0,0,1,2021-11-26
"garcia_saludes","aimplas",1,0,0,1,2021-11-26
"garcia_saludes","ainiatecnologia",1,0,0,1,2021-11-26
"garcia_saludes","aitex_es",1,0,0,1,2021-11-26
"garcia_saludes","ibv_org",1,0,0,1,2021-11-26
"garcia_saludes","InescopTech",1,0,0,1,2021-11-26
"garcia_saludes","ITC_ceramica",1,0,0,1,2021-11-26
"garcia_saludes","itene",1,0,0,1,2021-11-26
"garcia_saludes","itenergia",1,0,0,1,2021-11-26
"garcia_saludes","ITI_TIC",1,0,0,1,2021-11-26
"garcia_saludes","Saludes_Ind",1,0,0,1,2021-11-26
"gastronomiayfit","aimplas",1,0,0,1,2021-11-26
"gastronomiayfit","gastronomiayfit",0,0,1,1,2021-11-26
"GBDC78","aimplas",1,0,0,1,2021-11-26
"GBDC78","Benkei_Fr",1,0,0,1,2021-11-26
"GBDC78","CT_IPC",1,0,0,1,2021-11-26
"GBDC78","filigrade",1,0,0,1,2021-11-26
"GBDC78","PellencGroup",1,0,0,1,2021-11-26
"GBDC78","Pollutec",1,0,0,1,2021-11-26
"GBDC78","ProspexInst",1,0,0,1,2021-11-26
"gbelenguer","Aranviyu",1,0,0,1,2021-11-26
"gbelenguer","asociacionruvid",1,0,0,1,2021-11-26
"gbelenguer","AVEmpresarios",1,0,0,1,2021-11-26
"gbelenguer","BVilata",1,0,0,1,2021-11-26
"gbelenguer","emparmbonafe",1,0,0,1,2021-11-26
"gbelenguer","FundacionETNOR",1,0,0,1,2021-11-26
"gbelenguer","garcia_saludes",1,0,0,1,2021-11-26
"gbelenguer","GVAddigital",1,0,0,1,2021-11-26
"gbelenguer","GVAivace",1,0,0,1,2021-11-26
"gbelenguer","ibv_org",1,0,0,1,2021-11-26
"gbelenguer","itene",1,0,0,1,2021-11-26
"gbelenguer","ITI_TIC",1,0,0,1,2021-11-26
"gbelenguer","palbeme",1,0,0,1,2021-11-26
"gbelenguer","PremiosReiJaume",1,0,0,1,2021-11-26
"gbelenguer","RectoraUA",1,0,0,1,2021-11-26
"gbelenguer","Sebastia_Jordi",1,0,0,1,2021-11-26
"gbelenguer","teatroolympia",1,0,0,1,2021-11-26
"gbelenguer","UA_Universidad",1,0,0,1,2021-11-26
"generalitat","aimplas",1,0,0,1,2021-11-26
"generalitat","GlobalOmnium",1,0,0,1,2021-11-26
"generalitat","GVAavi",1,0,0,1,2021-11-26
"generalitat","lifesequencing",1,0,0,1,2021-11-26
"generalitat","UV_EG",1,0,0,1,2021-11-26
"GimenoGroup","aimplas",1,0,0,1,2021-11-26
"GimenoGroup","geqo_rseq",1,0,0,1,2021-11-26
"GimenoGroup","inbiotecenlared",1,0,0,1,2021-11-26
"GimenoGroup","IQAR_UAH",1,0,0,1,2021-11-26
"GimenoGroup","lualnu10",1,0,0,1,2021-11-26
"GimenoGroup","UAHes",1,0,0,1,2021-11-26
"GoHubTech","angelramire",1,0,0,1,2021-11-26
"GoHubTech","GoHubTech",0,0,1,1,2021-11-26
"GoHubTech","JuanPeaIbaez2",1,0,0,1,2021-11-26
"GoHubTech","pepesiega",1,0,0,1,2021-11-26
"GRACE_BBI","aimplas",1,0,0,1,2021-11-26
"GRACE_BBI","BarillaCFN",1,0,0,1,2021-11-26
"GRACE_BBI","BioVale_Cluster",1,0,0,1,2021-11-26
"GRACE_BBI","coopagrariesCAT",1,0,0,1,2021-11-26
"GRACE_BBI","fertinagro",1,0,0,1,2021-11-26
"GRACE_BBI","Fraunhofer",1,0,0,1,2021-11-26
"GRACE_BBI","iris_rd",1,0,0,1,2021-11-26
"GRACE_BBI","irtacat",1,0,0,1,2021-11-26
"GRACE_BBI","itene",1,0,0,1,2021-11-26
"GRACE_BBI","mogumycelium",1,0,0,1,2021-11-26
"Grupo_Soledad","aimplas",1,0,0,1,2021-11-26
"Grupo_Soledad","BancoSabadell",1,0,0,1,2021-11-26
"Grupo_Soledad","levante_emv",1,0,0,1,2021-11-26
"grupoenercoop","aimplas",1,0,0,1,2021-11-26
"grupoenercoop","itenergia",1,0,0,1,2021-11-26
"GrupoTHM","ainiatecnologia",1,0,0,1,2021-11-26
"GrupoTorrent","aimplas",1,0,0,1,2021-11-26
"GrupoTorrent","ANAIP_es",1,0,0,1,2021-11-26
"GrupoTorrent","ANARPLA",1,0,0,1,2021-11-26
"GrupoTorrent","AvepAsociacion",1,0,0,1,2021-11-26
"GrupoTorrent","Cicloplast_com",1,0,0,1,2021-11-26
"GrupoTorrent","esplasticos",1,0,0,1,2021-11-26
"GrupoTorrent","PlasticsEuropES",1,0,0,1,2021-11-26
"GuiaJuguete","aimplas",1,0,0,1,2021-11-26
"GuiaJuguete","Oceanografic_vl",1,0,0,1,2021-11-26
"GVAavi","Cooplliria",1,0,0,1,2021-11-26
"GVAavi","CSIC",0,1,0,1,2021-11-26
"GVAavi","FuturEnviro",0,1,0,1,2021-11-26
"GVAavi","informacion_es",1,0,0,1,2021-11-26
"GVAavi","UA_Universidad",1,0,0,1,2021-11-26
"GVAeconomia","CentrosCex",1,0,0,1,2021-11-26
"GVAeconomia","GVAeconomia",0,0,1,1,2021-11-26
"GVAeconomia","Julia_company",1,0,0,1,2021-11-26
"GVAeconomia","skrollerbelt",1,0,0,1,2021-11-26
"GVAinnova","generalitat",1,0,0,1,2021-11-26
"GVAivace","AIJU_Tecnologi",1,0,0,1,2021-11-26
"GVAivace","aitex_es",1,0,0,1,2021-11-26
"GVAivace","BancoSabadell",1,0,0,1,2021-11-26
"GVAivace","casasinhaus",1,0,0,1,2021-11-26
"GVAivace","CDTIoficial",1,0,0,1,2021-11-26
"GVAivace","escamilla50",1,0,0,1,2021-11-26
"GVAivace","gbelenguer",1,0,0,1,2021-11-26
"GVAivace","GVAeconomia",0,1,0,1,2021-11-26
"GVAivace","HorizonteEuropa",1,0,0,1,2021-11-26
"GVAivace","itenergia",1,0,0,1,2021-11-26
"GVAivace","ITI_TIC",1,0,0,1,2021-11-26
"GVAivace","microempresa",1,0,0,1,2021-11-26
"GVAivace","RebecaOntinyent",1,0,0,1,2021-11-26
"GVAivace","Sebastia_Jordi",1,0,0,1,2021-11-26
"GVAportaveu","AIDIMME",1,0,0,1,2021-11-26
"GVAportaveu","AIJU_Tecnologi",1,0,0,1,2021-11-26
"GVAportaveu","aimplas",1,0,0,1,2021-11-26
"GVAportaveu","aitex_es",1,0,0,1,2021-11-26
"GVAportaveu","GVAeconomia",1,0,0,1,2021-11-26
"GVAportaveu","GVAlabora",1,0,0,1,2021-11-26
"GVAportaveu","InescopTech",1,0,0,1,2021-11-26
"GVAvicepres2n","AIDIMME",1,0,0,1,2021-11-26
"GVAvicepres2n","AIJU_Tecnologi",1,0,0,1,2021-11-26
"GVAvicepres2n","aimplas",1,0,0,1,2021-11-26
"GVAvicepres2n","laurasfrances",1,0,0,1,2021-11-26
"GVAvicepres2n","matarredona_nur",1,0,0,1,2021-11-26
"GVAvicepres2n","Redit_es",1,0,0,1,2021-11-26
"H2020_Partner","accio_cat",1,0,0,1,2021-11-26
"H2020_Partner","aimplas",1,0,0,1,2021-11-26
"H2020_Partner","AristosInfo",1,0,0,1,2021-11-26
"H2020_Partner","biocat_cat",1,0,0,1,2021-11-26
"H2020_Partner","CDTIoficial",1,0,0,1,2021-11-26
"H2020_Partner","eencat",1,0,0,1,2021-11-26
"H2020_Partner","Eurecat_news",1,0,0,1,2021-11-26
"H2020_Partner","horizonexperts",1,0,0,1,2021-11-26
"H2020_Partner","itene",1,0,0,1,2021-11-26
"H2020_Partner","JCGarcia_CDTI",1,0,0,1,2021-11-26
"H2020_Partner","jordipietx",1,0,0,1,2021-11-26
"H2020_Partner","RosaAriasAlv",1,0,0,1,2021-11-26
"H2020_Partner","scibus",1,0,0,1,2021-11-26
"H2020_Partner","SorosGabinete",1,0,0,1,2021-11-26
"H2020_Partner","Wendy_Moreno_EU",1,0,0,1,2021-11-26
"HABRILAN","Airbus",1,0,0,1,2021-11-26
"HABRILAN","AvepAsociacion",1,0,0,1,2021-11-26
"HABRILAN","CompositesQuim",1,0,0,1,2021-11-26
"HABRILAN","CompositesSpain",1,0,0,1,2021-11-26
"HABRILAN","DANOBATGROUP",1,0,0,1,2021-11-26
"HABRILAN","easyfairsiberia",1,0,0,1,2021-11-26
"HABRILAN","Equiplast",1,0,0,1,2021-11-26
"HABRILAN","EsAirbus",1,0,0,1,2021-11-26
"HABRILAN","esplasticos",1,0,0,1,2021-11-26
"HABRILAN","Eurosurfas",1,0,0,1,2021-11-26
"HABRILAN","expoquimia",1,0,0,1,2021-11-26
"HABRILAN","Feria_Valencia",1,0,0,1,2021-11-26
"HABRILAN","feriaecofira",1,0,0,1,2021-11-26
"HABRILAN","Fira_Barcelona",1,0,0,1,2021-11-26
"HABRILAN","GVAivace",1,0,0,1,2021-11-26
"HABRILAN","IFEMA",1,0,0,1,2021-11-26
"HABRILAN","MetalMadridEs",1,0,0,1,2021-11-26
"HABRILAN","MtorresRsc",1,0,0,1,2021-11-26
"HABRILAN","TalgoGroup",1,0,0,1,2021-11-26
"HABRILAN","tecnalia",1,0,0,1,2021-11-26
"HABRILAN","UdGPolitecnica",1,0,0,1,2021-11-26
"hasta_el_lunes","canalsur",1,0,0,1,2021-11-26
"hasta_el_lunes","canalsurcordoba",1,0,0,1,2021-11-26
"hasta_el_lunes","ensgismau",1,0,0,1,2021-11-26
"hasta_el_lunes","hasta_el_lunes",0,0,1,1,2021-11-26
"hasta_el_lunes","manavas21",1,0,0,1,2021-11-26
"hasta_el_lunes","vir_montero",1,0,0,1,2021-11-26
"heroes_urbanos","aimplas",1,0,0,1,2021-11-26
"heroes_urbanos","CORDIS_EU",1,0,0,1,2021-11-26
"heroes_urbanos","URBANREC_H2020",1,0,0,1,2021-11-26
"HGUVALENCIA","aimplas",1,0,0,1,2021-11-26
"HGUVALENCIA","HGUVALENCIA",1,0,0,1,2021-11-26
"HGUVALENCIA","ibv_org",1,0,0,1,2021-11-26
"HGUVALENCIA","IRTIC_UV",1,0,0,1,2021-11-26
"Hispackbcn","Cicloplast_com",1,0,0,1,2021-11-26
"Hispackbcn","esplasticos",1,0,0,1,2021-11-26
"Hispacoop","aimplas",1,0,0,1,2021-11-26
"HorizonBooster","aimplas",1,0,0,1,2021-11-26
"HorizonBooster","RECOTRANS_H2020",1,0,0,1,2021-11-26
"Horticom","aimplas",1,0,0,1,2021-11-26
"HospitalLaFe","aimplas",1,0,0,1,2021-11-26
"HospitalLaFe","Betelgeux_es",1,0,0,1,2021-11-26
"HospitalLaFe","GVAavi",1,0,0,1,2021-11-26
"HospitalLaFe","HospitalLaFe",1,0,0,1,2021-11-26
"HospitalLaFe","IISLaFe",1,0,0,1,2021-11-26
"HospitalLaFe","ITQ_UPVCSIC",1,0,0,1,2021-11-26
"HospitalLaFe","UPV",1,0,0,1,2021-11-26
"i_alimentacion","ainiatecnologia",1,0,0,1,2021-11-26
"i_cardenal","aimplas",1,0,0,1,2021-11-26
"i_cardenal","i_cardenal",0,0,1,1,2021-11-26
"iambiente","itenergia",1,0,0,1,2021-11-26
"IBIAE","IESLaFoiaIbi",1,0,0,1,2021-11-26
"ibv_org","3DPrinting_Des",1,0,0,1,2021-11-26
"ibv_org","AutPortValencia",1,0,0,1,2021-11-26
"ibv_org","elperiodic",1,0,0,1,2021-11-26
"ibv_org","floridauni",1,0,0,1,2021-11-26
"ibv_org","GeriatricArea",1,0,0,1,2021-11-26
"ibv_org","IMMedicoHosp",1,0,0,1,2021-11-26
"ibv_org","Institutoai2upv",1,0,0,1,2021-11-26
"ibv_org","int_impresion3D",1,0,0,1,2021-11-26
"ibv_org","LaVanguardia",1,0,0,1,2021-11-26
"ibv_org","prevencionar",1,0,0,1,2021-11-26
"ibv_org","UV_EG",1,0,0,1,2021-11-26
"idainature","aimplas",1,0,0,1,2021-11-26
"IDEKO_","AEMAC_",1,0,0,1,2021-11-26
"IDEKO_","aernnova_usa",1,0,0,1,2021-11-26
"IDEKO_","aeroespacialUPM",1,0,0,1,2021-11-26
"IDEKO_","aimplas",1,0,0,1,2021-11-26
"IDEKO_","AirbusHeli",1,0,0,1,2021-11-26
"IDEKO_","amade_udg",1,0,0,1,2021-11-26
"IDEKO_","DanobatSheetMet",1,0,0,1,2021-11-26
"IDEKO_","HexcelCorp",1,0,0,1,2021-11-26
"IDEKO_","IDEKO_",1,0,0,1,2021-11-26
"IDEKO_","TalgoGroup",1,0,0,1,2021-11-26
"IDEKO_","tsisl_oficial",1,0,0,1,2021-11-26
"IDiBE_UMH","aimplas",1,0,0,1,2021-11-26
"IfapaOlivar","aimplas",1,0,0,1,2021-11-26
"IfapaOlivar","mercacei",0,1,0,1,2021-11-26
"IFATworldwide","aimplas",1,0,0,1,2021-11-26
"IFATworldwide","DafiaProject",1,0,0,1,2021-11-26
"IMDEA_Agua","aimplas",1,0,0,1,2021-11-26
"IMDEA_Agua","IMDEA_Agua",1,0,0,1,2021-11-26
"impulsa_ciu","aimplas",1,0,0,1,2021-11-26
"inam_uji","aimplas",1,0,0,1,2021-11-26
"IndustrialesCV","aimplas",1,0,0,1,2021-11-26
"IndustrialesCV","UPV",1,0,0,1,2021-11-26
"Industrias_TAYG","aimplas",1,0,0,1,2021-11-26
"Industrias_TAYG","Mundoplast",1,0,0,1,2021-11-26
"industry_arena","accio_cat",1,0,0,1,2021-11-26
"industry_arena","AMETIC_es",1,0,0,1,2021-11-26
"industry_arena","ascameorg",1,0,0,1,2021-11-26
"industry_arena","asegre01",1,0,0,1,2021-11-26
"industry_arena","camarascomercio",1,0,0,1,2021-11-26
"industry_arena","cambrabcn",1,0,0,1,2021-11-26
"industry_arena","eoi",1,0,0,1,2021-11-26
"industry_arena","Eurecat",1,0,0,1,2021-11-26
"industry_arena","FIDAMC_",1,0,0,1,2021-11-26
"industry_arena","industrialesand",1,0,0,1,2021-11-26
"industry_arena","industry_arena",0,0,1,1,2021-11-26
"industry_arena","InnovALuy",1,0,0,1,2021-11-26
"industry_arena","mincoturgob",1,0,0,1,2021-11-26
"industry_arena","packcluster",1,0,0,1,2021-11-26
"industry_arena","PatronalCecot",1,0,0,1,2021-11-26
"industry_arena","PT3NEO",1,0,0,1,2021-11-26
"IndustryTalksES","Actecosl",1,0,0,1,2021-11-26
"IndustryTalksES","Agenda2030Gob",1,0,0,1,2021-11-26
"IndustryTalksES","airesaslu",1,0,0,1,2021-11-26
"IndustryTalksES","BlueplasmaPower",1,0,0,1,2021-11-26
"IndustryTalksES","SustainableInnE",1,0,0,1,2021-11-26
"InescopTech","AIDIMME",1,0,0,1,2021-11-26
"InescopTech","aimplas",1,0,0,1,2021-11-26
"InescopTech","alicanteplaza",1,0,0,1,2021-11-26
"InescopTech","maytedomingo_",0,1,0,1,2021-11-26
"InescopTech","valenciaplaza",1,0,0,1,2021-11-26
"infoagrocom","Cicloplast",1,0,0,1,2021-11-26
"infoagrocom","UV_EG",1,0,0,1,2021-11-26
"informaciontvA","aimplas",1,0,0,1,2021-11-26
"informaciontvA","GVAavi",1,0,0,1,2021-11-26
"informaciontvA","ITC_Packaging",1,0,0,1,2021-11-26
"informaciontvA","nandorico16",1,0,0,1,2021-11-26
"informaciontvA","UA_Universidad",1,0,0,1,2021-11-26
"informaciontvA","UA_Universitat",1,0,0,1,2021-11-26
"innotransfer","MosaikUrbanSys",1,0,0,1,2021-11-26
"innotransfer","SchneiderES",1,0,0,1,2021-11-26
"innotransfer","SGS_Spain",1,0,0,1,2021-11-26
"innotransfer","UJIuniversitat",1,0,0,1,2021-11-26
"InnowayST","aimplas",1,0,0,1,2021-11-26
"InnowayST","Cicloplast_com",1,0,0,1,2021-11-26
"InnowayST","industriambient",1,0,0,1,2021-11-26
"int_textil","aimplas",1,0,0,1,2021-11-26
"iolunadeJupiter","aimplas",1,0,0,1,2021-11-26
"iolunadeJupiter","Betelgeux_es",1,0,0,1,2021-11-26
"iolunadeJupiter","GVAavi",1,0,0,1,2021-11-26
"iolunadeJupiter","ITQ_UPVCSIC",1,0,0,1,2021-11-26
"IPPTalk","aimplas",1,0,0,1,2021-11-26
"IreneLarroy","accio_cat",1,0,0,1,2021-11-26
"IreneLarroy","aimplas",1,0,0,1,2021-11-26
"IreneLarroy","biocat_cat",1,0,0,1,2021-11-26
"IreneLarroy","CDTIoficial",1,0,0,1,2021-11-26
"IreneLarroy","eencat",1,0,0,1,2021-11-26
"IreneLarroy","Eurecat_news",1,0,0,1,2021-11-26
"IreneLarroy","H2020_Partner",1,0,0,1,2021-11-26
"IreneLarroy","horizonexperts",1,0,0,1,2021-11-26
"IreneLarroy","itene",1,0,0,1,2021-11-26
"IreneLarroy","JCGarcia_CDTI",1,0,0,1,2021-11-26
"IreneLarroy","jordipietx",1,0,0,1,2021-11-26
"IreneLarroy","marcsattacks",1,0,0,1,2021-11-26
"IreneLarroy","RosaAriasAlv",1,0,0,1,2021-11-26
"IreneLarroy","scibus",1,0,0,1,2021-11-26
"IreneLarroy","SorosGabinete",1,0,0,1,2021-11-26
"IreneLarroy","talk2much12",1,0,0,1,2021-11-26
"IreneLarroy","Wendy_Moreno_EU",1,0,0,1,2021-11-26
"iResiduo","ANARPLA",1,0,0,1,2021-11-26
"iResiduo","AvepAsociacion",1,0,0,1,2021-11-26
"iResiduo","Cicloplast_com",1,0,0,1,2021-11-26
"iResiduo","PlasticsEuropES",1,0,0,1,2021-11-26
"istobal_es","aimplas",1,0,0,1,2021-11-26
"istobal_es","BancoSabadell",1,0,0,1,2021-11-26
"istobal_es","Grupo_Soledad",1,0,0,1,2021-11-26
"istobal_es","levante_emv",1,0,0,1,2021-11-26
"istobal_es","sabadellprensa",0,1,0,1,2021-11-26
"ISWA_org","CTAG_Materials",1,0,0,1,2021-11-26
"ISWA_org","Daimler",1,0,0,1,2021-11-26
"ISWA_org","panasonic",1,0,0,1,2021-11-26
"ISWA_org","panasonic_lstr",1,0,0,1,2021-11-26
"ITACYL","Fundacion_CTME",1,0,0,1,2021-11-26
"ITACYL","inbiotecenlared",1,0,0,1,2021-11-26
"ITACYL","Vitartis",1,0,0,1,2021-11-26
"ItalyFoodTrade","CommuneCulture",1,0,0,1,2021-11-26
"ItalyFoodTrade","foodtechconnect",1,0,0,1,2021-11-26
"ItalyFoodTrade","FoodTechFi",1,0,0,1,2021-11-26
"ItalyFoodTrade","FoodTechMatters",1,0,0,1,2021-11-26
"ItalyFoodTrade","FoodTechUAE",1,0,0,1,2021-11-26
"ItalyFoodTrade","IFT",1,0,0,1,2021-11-26
"ItalyFoodTrade","ItalyFoodTrade",0,0,1,1,2021-11-26
"ItalyFoodTrade","oceana",1,0,0,1,2021-11-26
"ItalyFoodTrade","OceanaEurope",1,0,0,1,2021-11-26
"ItalyFoodTrade","SweFoodTech",1,0,0,1,2021-11-26
"ITC_ceramica","AgEInves",1,0,0,1,2021-11-26
"ITC_ceramica","asociacionruvid",1,0,0,1,2021-11-26
"ITC_ceramica","CLAMDesarrollo",1,0,0,1,2021-11-26
"ITC_ceramica","copecastellon",0,1,0,1,2021-11-26
"ITC_ceramica","CSICval",1,0,0,1,2021-11-26
"ITC_ceramica","exagres",1,0,0,1,2021-11-26
"ITC_ceramica","FConexus",1,0,0,1,2021-11-26
"ITC_ceramica","Fedit",1,0,0,1,2021-11-26
"ITC_ceramica","Fritta_slu",1,0,0,1,2021-11-26
"ITC_ceramica","GVAddigital",1,0,0,1,2021-11-26
"ITC_ceramica","GVAinnova",1,0,0,1,2021-11-26
"ITC_ceramica","KerabenGrupo",1,0,0,1,2021-11-26
"ITC_ceramica","ReciclaliaC",1,0,0,1,2021-11-26
"ITC_ceramica","seimedcv",1,0,0,1,2021-11-26
"ITC_ceramica","SiemensGamesaES",1,0,0,1,2021-11-26
"ITC_ceramica","sofitec_",1,0,0,1,2021-11-26
"ITC_ceramica","Startup_VLC",1,0,0,1,2021-11-26
"ITC_ceramica","UJIuniversitat",1,0,0,1,2021-11-26
"ITC_ceramica","universitat",1,0,0,1,2021-11-26
"itenergia","igcamag",1,0,0,1,2021-11-26
"itenergia","jaceral",1,0,0,1,2021-11-26
"itenergia","jmasbelso",1,0,0,1,2021-11-26
"itenergia","nexusintegra",1,0,0,1,2021-11-26
"ITI_TIC","AdelaRuizD",1,0,0,1,2021-11-26
"ITI_TIC","ivace",1,0,0,1,2021-11-26
"ITQ_UPVCSIC","Betelgeux_es",1,0,0,1,2021-11-26
"ITQ_UPVCSIC","CSIC",1,0,0,1,2021-11-26
"ITQ_UPVCSIC","CSICval",1,0,0,1,2021-11-26
"ITQ_UPVCSIC","HospitalLaFe",1,0,0,1,2021-11-26
"ITQ_UPVCSIC","Industrias_TAYG",1,0,0,1,2021-11-26
"ITQ_UPVCSIC","itmupv",1,0,0,1,2021-11-26
"ivanalbertos81","aimplas",1,0,0,1,2021-11-26
"ivanalbertos81","BASF_ES",1,0,0,1,2021-11-26
"ivanalbertos81","Petstarmx",1,0,0,1,2021-11-26
"ivanalbertos81","Recuwaste",1,0,0,1,2021-11-26
"izarotech","ainiatecnologia",1,0,0,1,2021-11-26
"izarotech","AvepAsociacion",1,0,0,1,2021-11-26
"izarotech","CIDETEC_",1,0,0,1,2021-11-26
"izarotech","ENAC_acredita",1,0,0,1,2021-11-26
"izarotech","InescopTech",1,0,0,1,2021-11-26
"izarotech","Nestle_es",1,0,0,1,2021-11-26
"izarotech","PlasticsEurope",1,0,0,1,2021-11-26
"izarotech","tecnalia",1,0,0,1,2021-11-26
"izarotech","TeknikerOficial",1,0,0,1,2021-11-26
"IzasaScientific","jcst2801",1,0,0,1,2021-11-26
"jadfrias","aimplas",1,0,0,1,2021-11-26
"jadfrias","BASF_ES",1,0,0,1,2021-11-26
"jadfrias","Repsol",1,0,0,1,2021-11-26
"jadfrias","SABIC",1,0,0,1,2021-11-26
"javiergarciamar","AIDIMME",1,0,0,1,2021-11-26
"javiergarciamar","AIJU_Tecnologi",1,0,0,1,2021-11-26
"javiergarciamar","aimplas",1,0,0,1,2021-11-26
"javiergarciamar","ainiatecnologia",1,0,0,1,2021-11-26
"javiergarciamar","aitex_es",1,0,0,1,2021-11-26
"javiergarciamar","Fedit",1,0,0,1,2021-11-26
"javiergarciamar","InescopTech",1,0,0,1,2021-11-26
"javiergarciamar","ITC_ceramica",1,0,0,1,2021-11-26
"javiergarciamar","itenergia",1,0,0,1,2021-11-26
"javiergarciamar","Redit_es",1,0,0,1,2021-11-26
"jealvarez","ACortinaPantion",1,0,0,1,2021-11-26
"jealvarez","Correos",1,0,0,1,2021-11-26
"jealvarez","cristinasancho",1,0,0,1,2021-11-26
"jealvarez","EspejoPublico",1,0,0,1,2021-11-26
"jealvarez","foroinserta",1,0,0,1,2021-11-26
"jealvarez","IKEASpain",1,0,0,1,2021-11-26
"JECComposites","TeknikerOficial",1,0,0,1,2021-11-26
"JECComposites","TNO_Research",1,0,0,1,2021-11-26
"jesus_calvo","aimplas",1,0,0,1,2021-11-26
"joanros78","AvepAsociacion",1,0,0,1,2021-11-26
"joanros78","GVAinnova",1,0,0,1,2021-11-26
"JorgeGdeOpazo","aimplas",1,0,0,1,2021-11-26
"JorgeGdeOpazo","CdeCarnica",1,0,0,1,2021-11-26
"joveryolanda","aimplas",1,0,0,1,2021-11-26
"joveryolanda","coneselisa",1,0,0,1,2021-11-26
"joveryolanda","Oceanografic_vl",1,0,0,1,2021-11-26
"joveryolanda","placadelllibre",1,0,0,1,2021-11-26
"jp_torregrosa","aimplas",1,0,0,1,2021-11-26
"jp_torregrosa","BIOVAL_es",1,0,0,1,2021-11-26
"jp_torregrosa","itenergia",1,0,0,1,2021-11-26
"juliabrines","aimplas",1,0,0,1,2021-11-26
"juliabrines","expansioncom",1,0,0,1,2021-11-26
"juliatomas3","aimplas",1,0,0,1,2021-11-26
"KerabenGrupo","aimplas",1,0,0,1,2021-11-26
"khaqanshati","aimplas",1,0,0,1,2021-11-26
"khaqanshati","CalipsoPlus",1,0,0,1,2021-11-26
"khaqanshati","cepyme_",1,0,0,1,2021-11-26
"khaqanshati","confemetal",1,0,0,1,2021-11-26
"khaqanshati","Feique_ES",1,0,0,1,2021-11-26
"KimitecGroup","CDTIoficial",1,0,0,1,2021-11-26
"KimitecGroup","CienciaGob",1,0,0,1,2021-11-26
"KimitecGroup","InfoUMA",1,0,0,1,2021-11-26
"KimitecGroup","ualmeria",1,0,0,1,2021-11-26
"KimitecGroup","UPV",1,0,0,1,2021-11-26
"LAB_Ecoinnova","Actecosl",1,0,0,1,2021-11-26
"LAB_Ecoinnova","aimplas",1,0,0,1,2021-11-26
"LAB_Ecoinnova","BioICEP_IMGGE",1,0,0,1,2021-11-26
"LAB_Ecoinnova","RevistaRETEMA",1,0,0,1,2021-11-26
"LaboralLab_","aimplas",1,0,0,1,2021-11-26
"LaboralLab_","antena3com",1,0,0,1,2021-11-26
"LaboralLab_","AsocEyC",1,0,0,1,2021-11-26
"LaboralLab_","Correos",1,0,0,1,2021-11-26
"LaboralLab_","EspejoPublico",1,0,0,1,2021-11-26
"LaboralLab_","foroinserta",1,0,0,1,2021-11-26
"LaboralLab_","Fundacion_ONCE",1,0,0,1,2021-11-26
"LaBrujulaCV_OCR","OndaCero_es",1,0,0,1,2021-11-26
"LaBrujulaCV_OCR","Redit_es",1,0,0,1,2021-11-26
"lacarolinajaen","aimplas",1,0,0,1,2021-11-26
"lacarolinajaen","CentrosCex",1,0,0,1,2021-11-26
"lacarolinajaen","escamilla50",1,0,0,1,2021-11-26
"lacarolinajaen","generalitat",1,0,0,1,2021-11-26
"lacarolinajaen","GVAivace",1,0,0,1,2021-11-26
"lacarolinajaen","Julia_company",1,0,0,1,2021-11-26
"lacarolinajaen","Rafa_Climentg",1,0,0,1,2021-11-26
"LanzaTech","aimplas",1,0,0,1,2021-11-26
"LaPalestraJca","aimplas",1,0,0,1,2021-11-26
"LaPalestraJca","MatiesAmparo",1,0,0,1,2021-11-26
"LasNaves","aimplas",1,0,0,1,2021-11-26
"LasNaves","AjuntamentVLC",1,0,0,1,2021-11-26
"LasNaves","carlosgaliana",1,0,0,1,2021-11-26
"LasNaves","martachillaron",1,0,0,1,2021-11-26
"LifeEpsSure","4filmLife",1,0,0,1,2021-11-26
"LifeEpsSure","ANAIP_es",1,0,0,1,2021-11-26
"LifeEpsSure","andaltec",1,0,0,1,2021-11-26
"LifeEpsSure","lifeplasmix",1,0,0,1,2021-11-26
"LifeEpsSure","ResiduosPro",1,0,0,1,2021-11-26
"lilifondevila","aimplas",1,0,0,1,2021-11-26
"LinkenerSpain","angelramire",1,0,0,1,2021-11-26
"LinkenerSpain","EosOrbital",1,0,0,1,2021-11-26
"LinkenerSpain","GlobalOmnium",1,0,0,1,2021-11-26
"LinkenerSpain","GoHubTech",1,0,0,1,2021-11-26
"LinkenerSpain","JuanPeaIbaez2",1,0,0,1,2021-11-26
"LinkenerSpain","LinkenerSpain",1,0,0,1,2021-11-26
"LinkenerSpain","pepesiega",1,0,0,1,2021-11-26
"LISSolutionsTW","iVale7",1,0,0,1,2021-11-26
"LolaFPaniagua","ainiatecnologia",1,0,0,1,2021-11-26
"LolaFPaniagua","ANAIP_es",1,0,0,1,2021-11-26
"LolaFPaniagua","ANARPLA",1,0,0,1,2021-11-26
"LolaFPaniagua","danone_es",1,0,0,1,2021-11-26
"LolaFPaniagua","faerchgroup",1,0,0,1,2021-11-26
"LolaFPaniagua","Nestle_es",1,0,0,1,2021-11-26
"LolaFPaniagua","UV_EG",1,0,0,1,2021-11-26
"londones","aimplas",1,0,0,1,2021-11-26
"londones","corifyAF",1,0,0,1,2021-11-26
"londones","Grupo_TSK",1,0,0,1,2021-11-26
"londones","Molecor",1,0,0,1,2021-11-26
"londones","PigCHAMP_Europa",1,0,0,1,2021-11-26
"londones","skrollerbelt",1,0,0,1,2021-11-26
"LosPackaging","ainiatecnologia",1,0,0,1,2021-11-26
"LosPackaging","CdeCarnica",1,0,0,1,2021-11-26
"Luis_RoFe","AceiteOlivalle",1,0,0,1,2021-11-26
"Luis_RoFe","aimplas",1,0,0,1,2021-11-26
"luispatinoangel","aimplas",1,0,0,1,2021-11-26
"luispatinoangel","luispatinoangel",1,0,0,1,2021-11-26
"mafehegu","Cicloplast_com",1,0,0,1,2021-11-26
"manccampdeturia","aimplas",1,0,0,1,2021-11-26
"manccampdeturia","ajtlapobla",1,0,0,1,2021-11-26
"manccampdeturia","AjuntamentSerra",1,0,0,1,2021-11-26
"manccampdeturia","ajvilamarxant",1,0,0,1,2021-11-26
"manccampdeturia","ayto_riba_roja",1,0,0,1,2021-11-26
"manccampdeturia","AytoBenaguasil",1,0,0,1,2021-11-26
"manccampdeturia","Aytobetera",1,0,0,1,2021-11-26
"manccampdeturia","aytolliria",1,0,0,1,2021-11-26
"manccampdeturia","AytoLoriguilla",1,0,0,1,2021-11-26
"manccampdeturia","AytoMarines",1,0,0,1,2021-11-26
"manccampdeturia","AytoNaquera",1,0,0,1,2021-11-26
"manccampdeturia","AyuntamientoSAB",1,0,0,1,2021-11-26
"manccampdeturia","benissano",1,0,0,1,2021-11-26
"manccampdeturia","GVAlabora",1,0,0,1,2021-11-26
"MariaBellmunt","abionica_UAS",1,0,0,1,2021-11-26
"MariaBellmunt","aimplas",1,0,0,1,2021-11-26
"MariaBellmunt","brokair",1,0,0,1,2021-11-26
"MariaBellmunt","CDTIoficial",1,0,0,1,2021-11-26
"MariaBellmunt","Defensagob",1,0,0,1,2021-11-26
"MariaBellmunt","FGlobalis",0,1,0,1,2021-11-26
"MariaBellmunt","infoGMV_es",1,0,0,1,2021-11-26
"MariaBellmunt","PLD_Space",1,0,0,1,2021-11-26
"MaripeSamper","CentrosCex",1,0,0,1,2021-11-26
"MaripeSamper","escamilla50",1,0,0,1,2021-11-26
"MaripeSamper","generalitat",1,0,0,1,2021-11-26
"MaripeSamper","GVAivace",1,0,0,1,2021-11-26
"MaripeSamper","Julia_company",1,0,0,1,2021-11-26
"MaripeSamper","Rafa_Climentg",1,0,0,1,2021-11-26
"Marketing4Food","aimplas",1,0,0,1,2021-11-26
"Marketing4Food","Biopolis_SL",1,0,0,1,2021-11-26
"Marketing4Food","FEDACOVA_VLC",1,0,0,1,2021-11-26
"Marketing4Food","LACABEZUELA",1,0,0,1,2021-11-26
"Marketing4Food","quesodoshermana",1,0,0,1,2021-11-26
"Marketing4Food","UV_EG",1,0,0,1,2021-11-26
"MartaEGMosquera","AytoAlcalaH",1,0,0,1,2021-11-26
"MartaEGMosquera","CBachiller",1,0,0,1,2021-11-26
"MartaEGMosquera","lucilu_o13",1,0,0,1,2021-11-26
"MartaEGMosquera","MDPIOpenAccess",1,0,0,1,2021-11-26
"MartaEGMosquera","mWeek_Alcala",1,0,0,1,2021-11-26
"MartaEGMosquera","mWeek_MWC",1,0,0,1,2021-11-26
"martarojo_","aimplas",1,0,0,1,2021-11-26
"martarojo_","itenergia",1,0,0,1,2021-11-26
"Mateprincs","3Neo",1,0,0,1,2021-11-26
"Mateprincs","Cluster",1,0,0,1,2021-11-26
"Mateprincs","ep",1,0,0,1,2021-11-26
"Mateprincs","naitec",1,0,0,1,2021-11-26
"Mateprincs","swansea",1,0,0,1,2021-11-26
"Mateprincs","SwanseaUni",1,0,0,1,2021-11-26
"materplat","Adif_es",1,0,0,1,2021-11-26
"materplat","AgEInves",1,0,0,1,2021-11-26
"materplat","CIDETEC",1,0,0,1,2021-11-26
"materplat","CIDETEC_",1,0,0,1,2021-11-26
"materplat","CienciaGob",1,0,0,1,2021-11-26
"materplat","CTAG_Materials",1,0,0,1,2021-11-26
"materplat","mitmagob",1,0,0,1,2021-11-26
"materplat","Shift2Rail_JU",1,0,0,1,2021-11-26
"materplat","TalgoGroup",1,0,0,1,2021-11-26
"materplat","tecnalia",1,0,0,1,2021-11-26
"maytedomingo_","AIJU_Tecnologi",1,0,0,1,2021-11-26
"maytedomingo_","aitex_es",1,0,0,1,2021-11-26
"maytedomingo_","Faurecia",1,0,0,1,2021-11-26
"maytedomingo_","garcia_saludes",1,0,0,1,2021-11-26
"maytedomingo_","GreenTurf",1,0,0,1,2021-11-26
"maytedomingo_","iberapa",1,0,0,1,2021-11-26
"maytedomingo_","InescopTech",1,0,0,1,2021-11-26
"maytedomingo_","Julia_company",1,0,0,1,2021-11-26
"maytedomingo_","Porcelanosa_es",1,0,0,1,2021-11-26
"maytedomingo_","realturfoficial",1,0,0,1,2021-11-26
"maytedomingo_","Saludes_Ind",1,0,0,1,2021-11-26
"MediterraneoPre","aimplas",1,0,0,1,2021-11-26
"MediterraneoPre","GlobalOmnium",1,0,0,1,2021-11-26
"MediterraneoPre","GVAavi",1,0,0,1,2021-11-26
"MediterraneoPre","GVAinnova",1,0,0,1,2021-11-26
"MediterraneoPre","UVa_es",1,0,0,1,2021-11-26
"mercacei","aimplas",1,0,0,1,2021-11-26
"micijor","aimplas",1,0,0,1,2021-11-26
"micijor","coneselisa",1,0,0,1,2021-11-26
"micijor","Oceanografic_vl",1,0,0,1,2021-11-26
"micijor","placadelllibre",1,0,0,1,2021-11-26
"MinarroFin","aimplas",1,0,0,1,2021-11-26
"MinarroFin","VicenteAbella",1,0,0,1,2021-11-26
"MincienciasCo","aimplas",1,0,0,1,2021-11-26
"MincienciasCo","MincienciasCo",0,0,1,1,2021-11-26
"MincienciasCo","TitoCrissien",1,0,0,1,2021-11-26
"miyoresponsable","aimplas",1,0,0,1,2021-11-26
"MobilityVlc","AgfraSL",1,0,0,1,2021-11-26
"MobilityVlc","ibv_org",1,0,0,1,2021-11-26
"MobilityVlc","ITI_TIC",1,0,0,1,2021-11-26
"MobilityVlc","SGS_SA",1,0,0,1,2021-11-26
"Monviciano","AndreaFontanaEU",1,0,0,1,2021-11-26
"Monviciano","Dr_alshreka",1,0,0,1,2021-11-26
"Monviciano","EU_Commission",1,0,0,1,2021-11-26
"Monviciano","EU_FPI",1,0,0,1,2021-11-26
"Monviciano","EUgreenresearch",1,0,0,1,2021-11-26
"Monviciano","expo2020dubai",1,0,0,1,2021-11-26
"Monviciano","expo2020se",1,0,0,1,2021-11-26
"Monviciano","GCCSG",1,0,0,1,2021-11-26
"Monviciano","MICleanEnergyRD",1,0,0,1,2021-11-26
"MPN_Magazine","LeistritzCorp",1,0,0,1,2021-11-26
"mrtmi3g","aimplas",1,0,0,1,2021-11-26
"mtmachado","RevistaRETEMA",1,0,0,1,2021-11-26
"mtmachado","UV_EG",1,0,0,1,2021-11-26
"Mundoplast","aitiip",1,0,0,1,2021-11-26
"Mundoplast","AvepAsociacion",1,0,0,1,2021-11-26
"Mundoplast","CIDETEC_",1,0,0,1,2021-11-26
"Mundoplast","esplasticos",1,0,0,1,2021-11-26
"Mundoplast","GVAivace",1,0,0,1,2021-11-26
"Mundoplast","PlasticsEuropES",1,0,0,1,2021-11-26
"Mundoplast","raorsamaq",1,0,0,1,2021-11-26
"Mundoplast","UPV",1,0,0,1,2021-11-26
"Mundoplast","UV_EG",1,0,0,1,2021-11-26
"NanomedicineLab","aimplas",1,0,0,1,2021-11-26
"NanomedicineLab","CEA_Officiel",1,0,0,1,2021-11-26
"NanomedicineLab","DTUtweet",1,0,0,1,2021-11-26
"NanomedicineLab","EU_H2020",1,0,0,1,2021-11-26
"NanomedicineLab","FBMH_UoM",1,0,0,1,2021-11-26
"NanomedicineLab","FFIS_CARM",1,0,0,1,2021-11-26
"NanomedicineLab","FIOH",1,0,0,1,2021-11-26
"NanomedicineLab","Inserm_EN",1,0,0,1,2021-11-26
"NanomedicineLab","OfficialUoM",1,0,0,1,2021-11-26
"NanomedicineLab","ScienceMagazine",0,1,0,1,2021-11-26
"NanomedicineLab","UABBarcelona",1,0,0,1,2021-11-26
"NanomedicineLab","UFZ_de",1,0,0,1,2021-11-26
"NanomedicineLab","UniLeipzig",1,0,0,1,2021-11-26
"NanomedicineLab","WUR",1,0,0,1,2021-11-26
"NanomedSpain","aimplas",1,0,0,1,2021-11-26
"NanomedSpain","ClusterFPrint",1,0,0,1,2021-11-26
"NanomedSpain","fenin_es",1,0,0,1,2021-11-26
"NanomedSpain","NanomedSpain",1,0,0,1,2021-11-26
"NanomedSpain","PT3NEO",1,0,0,1,2021-11-26
"nemosineproject","aimplas",1,0,0,1,2021-11-26
"nemosineproject","nemosineproject",1,0,0,1,2021-11-26
"NormasUNE","aimplas",1,0,0,1,2021-11-26
"NormasUNE","ANAIP_es",1,0,0,1,2021-11-26
"Novamont_Iberia","expoquimia",1,0,0,1,2021-11-26
"Novamont_Iberia","materbi",1,0,0,1,2021-11-26
"nuevoagrodiario","aimplas",1,0,0,1,2021-11-26
"nuevoagrodiario","ainiatecnologia",1,0,0,1,2021-11-26
"Obrasurbanas","aimplas",1,0,0,1,2021-11-26
"OceanetsProject","cinea_eu",0,1,0,1,2021-11-26
"OceanetsProject","easme",1,0,0,1,2021-11-26
"OceanetsProject","GEN_Uvigo",1,0,0,1,2021-11-26
"OceanetsProject","marGnetproject",1,0,0,1,2021-11-26
"OceanetsProject","NetTagProject",1,0,0,1,2021-11-26
"OceanetsProject","rtve",1,0,0,1,2021-11-26
"OceanetsProject","vincenzo_gente",1,0,0,1,2021-11-26
"Oceanografic_vl","aimplas",1,0,0,1,2021-11-26
"Oceanografic_vl","CruzRojaEsp",1,0,0,1,2021-11-26
"OCRValencia","AIDIMME",1,0,0,1,2021-11-26
"OCRValencia","ainiatecnologia",1,0,0,1,2021-11-26
"OCRValencia","AjuntamentVLC",1,0,0,1,2021-11-26
"OCRValencia","AMITMu_Val",1,0,0,1,2021-11-26
"OCRValencia","amperexenergy",1,0,0,1,2021-11-26
"OCRValencia","AVAESEN",1,0,0,1,2021-11-26
"OCRValencia","Bego_Pe",1,0,0,1,2021-11-26
"OCRValencia","caixapopular",1,0,0,1,2021-11-26
"OCRValencia","carlosgaliana",1,0,0,1,2021-11-26
"OCRValencia","eduard_urena",1,0,0,1,2021-11-26
"OCRValencia","GVAivace",1,0,0,1,2021-11-26
"OCRValencia","ibv_org",1,0,0,1,2021-11-26
"OCRValencia","InescopTech",1,0,0,1,2021-11-26
"OCRValencia","ITC_ceramica",1,0,0,1,2021-11-26
"OCRValencia","itene",1,0,0,1,2021-11-26
"OCRValencia","itenergia",1,0,0,1,2021-11-26
"OCRValencia","ITI_TIC",1,0,0,1,2021-11-26
"OCRValencia","JMendigacha",1,0,0,1,2021-11-26
"OCRValencia","LafargeHolcimES",1,0,0,1,2021-11-26
"OCRValencia","laprimerapiedra",1,0,0,1,2021-11-26
"OCRValencia","malbors",1,0,0,1,2021-11-26
"OCRValencia","socialnest_org",1,0,0,1,2021-11-26
"OCRValencia","veintiuno_music",1,0,0,1,2021-11-26
"OEPM_es","protermosolar",1,0,0,1,2021-11-26
"OEPM_es","pteco2",1,0,0,1,2021-11-26
"OEPM_es","solarconcentra",1,0,0,1,2021-11-26
"OleoRevista","ainiatecnologia",1,0,0,1,2021-11-26
"OleoRevista","GVAivace",1,0,0,1,2021-11-26
"olgainfoedita","infoconstru",0,1,0,1,2021-11-26
"olgainfoedita","tecnoalimen",0,1,0,1,2021-11-26
"omenendez","aimplas",1,0,0,1,2021-11-26
"omenendez","Airbus",1,0,0,1,2021-11-26
"omenendez","BASF_ES",1,0,0,1,2021-11-26
"omenendez","Cefic",1,0,0,1,2021-11-26
"omenendez","deborahciencia",1,0,0,1,2021-11-26
"omenendez","foretica",1,0,0,1,2021-11-26
"omenendez","Pascual",1,0,0,1,2021-11-26
"omenendez","PlasticsEuropES",1,0,0,1,2021-11-26
"omenendez","Repsol",1,0,0,1,2021-11-26
"omenendez","SABIC",1,0,0,1,2021-11-26
"omenendez","ternua",1,0,0,1,2021-11-26
"ondalocalemartv","aimplas",1,0,0,1,2021-11-26
"ondalocalemartv","CoopsAgroAND",1,0,0,1,2021-11-26
"ondalocalemartv","Oliplast",1,0,0,1,2021-11-26
"opdi_tex_GmbH","aimplas",1,0,0,1,2021-11-26
"opdi_tex_GmbH","BcompLtd",1,0,0,1,2021-11-26
"opdi_tex_GmbH","CompPairTech",1,0,0,1,2021-11-26
"opdi_tex_GmbH","EDAGGroup",1,0,0,1,2021-11-26
"opdi_tex_GmbH","EireComposites",1,0,0,1,2021-11-26
"opdi_tex_GmbH","Fraunhofer_IWU",1,0,0,1,2021-11-26
"opdi_tex_GmbH","FraunhoferIGCV",1,0,0,1,2021-11-26
"opdi_tex_GmbH","MCAMconnect",1,0,0,1,2021-11-26
"opdi_tex_GmbH","NCCUKinfo",1,0,0,1,2021-11-26
"opdi_tex_GmbH","RWTH",1,0,0,1,2021-11-26
"OpenFuture_And","AgriculturAnd",1,0,0,1,2021-11-26
"OpenFuture_And","aimplas",1,0,0,1,2021-11-26
"OpenFuture_And","Bioeconomia_And",1,0,0,1,2021-11-26
"OpenFuture_And","CTAndalucia",1,0,0,1,2021-11-26
"OpenFuture_And","DataAgriS3",1,0,0,1,2021-11-26
"OpenFuture_And","DIHAndAgrotech",1,0,0,1,2021-11-26
"OpenFuture_And","eoi",1,0,0,1,2021-11-26
"OpenFuture_And","Fertinagro",1,0,0,1,2021-11-26
"OpenFuture_And","GrupoCosentino",1,0,0,1,2021-11-26
"OpenFuture_And","IBEROSTAR",1,0,0,1,2021-11-26
"OpenFuture_And","ImpactHubMAD",1,0,0,1,2021-11-26
"ORH_RH","aimplas",1,0,0,1,2021-11-26
"ORH_RH","AsocEyC",1,0,0,1,2021-11-26
"ORH_RH","Correos",1,0,0,1,2021-11-26
"ORH_RH","EspejoPublico",1,0,0,1,2021-11-26
"ORH_RH","foroinserta",1,0,0,1,2021-11-26
"OVTT","ainiatecnologia",1,0,0,1,2021-11-26
"OVTT","ITI_TIC",1,0,0,1,2021-11-26
"OVTT","Packnet_",1,0,0,1,2021-11-26
"OVTTenglish","OEPM_es",1,0,0,1,2021-11-26
"pablo24200","aimplas",1,0,0,1,2021-11-26
"pablo24200","ECOTOX2",1,0,0,1,2021-11-26
"pablo24200","EstrellaDammCat",1,0,0,1,2021-11-26
"pablo24200","EstrellaDammEs",1,0,0,1,2021-11-26
"pablo24200","FBiodiversidad",1,0,0,1,2021-11-26
"pablo24200","FValenciaport",1,0,0,1,2021-11-26
"pablo24200","prendente",1,0,0,1,2021-11-26
"pablo24200","uvigo",1,0,0,1,2021-11-26
"PackagingEurope","PackEuropeEli",1,0,0,1,2021-11-26
"packcluster","3Dnatives_ES",1,0,0,1,2021-11-26
"packcluster","AEBALL_UPMBALL",1,0,0,1,2021-11-26
"packcluster","AEMAC_",1,0,0,1,2021-11-26
"packcluster","AerAutomation",1,0,0,1,2021-11-26
"packcluster","aiasasociacion",1,0,0,1,2021-11-26
"packcluster","aimplas",1,0,0,1,2021-11-26
"packcluster","ascameorg",1,0,0,1,2021-11-26
"packcluster","camarascomercio",1,0,0,1,2021-11-26
"packcluster","cambrabcn",1,0,0,1,2021-11-26
"packcluster","CEPplast",1,0,0,1,2021-11-26
"packcluster","ClusterCICAT",1,0,0,1,2021-11-26
"packcluster","eoi",1,0,0,1,2021-11-26
"packcluster","Eurecat_news",1,0,0,1,2021-11-26
"packcluster","HispaRob",1,0,0,1,2021-11-26
"packcluster","industrialesand",1,0,0,1,2021-11-26
"packcluster","innovallcluster",1,0,0,1,2021-11-26
"packcluster","mincoturgob",1,0,0,1,2021-11-26
"packcluster","PatronalCecot",1,0,0,1,2021-11-26
"packcluster","SECARTYS",1,0,0,1,2021-11-26
"Packnet_","AEMPSGOB",1,0,0,1,2021-11-26
"Packnet_","ANAIP_es",1,0,0,1,2021-11-26
"Packnet_","artsolut",1,0,0,1,2021-11-26
"Packnet_","Decernis",1,0,0,1,2021-11-26
"Packnet_","EMSUR_",1,0,0,1,2021-11-26
"Packnet_","Feique_ES",1,0,0,1,2021-11-26
"Packnet_","Foro_READ",1,0,0,1,2021-11-26
"Packnet_","fpffoundation",1,0,0,1,2021-11-26
"Packnet_","GrupoHinojosa",1,0,0,1,2021-11-26
"Packnet_","GVAsanitat",1,0,0,1,2021-11-26
"Packnet_","int_envase",0,1,0,1,2021-11-26
"Packnet_","ITC_ceramica",1,0,0,1,2021-11-26
"Packnet_","itene",1,0,0,1,2021-11-26
"Packnet_","LATU_uy",1,0,0,1,2021-11-26
"Packnet_","PKF_ATTEST",1,0,0,1,2021-11-26
"Packnet_","stanpa_es",1,0,0,1,2021-11-26
"Packnet_","UV_EG",1,0,0,1,2021-11-26
"PacoDS","aimplas",1,0,0,1,2021-11-26
"PacoFernandezA2","aimplas",1,0,0,1,2021-11-26
"PacoFernandezA2","geqo_rseq",1,0,0,1,2021-11-26
"PacoFernandezA2","inbiotecenlared",1,0,0,1,2021-11-26
"PacoFernandezA2","IQAR_UAH",1,0,0,1,2021-11-26
"PacoFernandezA2","lualnu10",1,0,0,1,2021-11-26
"PacoFernandezA2","UAHes",1,0,0,1,2021-11-26
"PakoRho","aimplas",1,0,0,1,2021-11-26
"PakoRho","ainiatecnologia",1,0,0,1,2021-11-26
"PakoRho","Arturolarena",1,0,0,1,2021-11-26
"PakoRho","BelenFranch",1,0,0,1,2021-11-26
"PakoRho","cdcampo1",1,0,0,1,2021-11-26
"PakoRho","EFEverde",1,0,0,1,2021-11-26
"PakoRho","FGlobalNature",1,0,0,1,2021-11-26
"PakoRho","trypanus",1,0,0,1,2021-11-26
"parccientificuv","bioferric",1,0,0,1,2021-11-26
"parccientificuv","CatedraAguas",1,0,0,1,2021-11-26
"parccientificuv","DarwinBioprosp",1,0,0,1,2021-11-26
"parccientificuv","FacFarmacia_UV",1,0,0,1,2021-11-26
"parccientificuv","GlobalOmnium",1,0,0,1,2021-11-26
"parccientificuv","iata_csic",1,0,0,1,2021-11-26
"parccientificuv","innotransfer",1,0,0,1,2021-11-26
"parccientificuv","UJIuniversitat",1,0,0,1,2021-11-26
"Pascual","3duardoFG",1,0,0,1,2021-11-26
"Pascual","abc_es",1,0,0,1,2021-11-26
"Pascual","aimplas",1,0,0,1,2021-11-26
"Pascual","Airbus",1,0,0,1,2021-11-26
"Pascual","BASF_ES",1,0,0,1,2021-11-26
"Pascual","Cefic",1,0,0,1,2021-11-26
"Pascual","charo_barroso",1,0,0,1,2021-11-26
"Pascual","deborahciencia",1,0,0,1,2021-11-26
"Pascual","Equiplast",1,0,0,1,2021-11-26
"Pascual","EsAirbus",1,0,0,1,2021-11-26
"Pascual","esplasticos",1,0,0,1,2021-11-26
"Pascual","Feique_ES",1,0,0,1,2021-11-26
"Pascual","foretica",1,0,0,1,2021-11-26
"Pascual","ForoQyS",1,0,0,1,2021-11-26
"Pascual","omenendez",1,0,0,1,2021-11-26
"Pascual","PlasticsEuropES",1,0,0,1,2021-11-26
"Pascual","Repsol",1,0,0,1,2021-11-26
"Pascual","SABIC",1,0,0,1,2021-11-26
"Pascual","SusChemSpain",1,0,0,1,2021-11-26
"Pascual","ternua",1,0,0,1,2021-11-26
"Pascual","TFundaciones",1,0,0,1,2021-11-26
"PCientificoAlic","AIJU_Tecnologi",1,0,0,1,2021-11-26
"PCientificoAlic","aimplas",1,0,0,1,2021-11-26
"PCientificoAlic","AvepAsociacion",1,0,0,1,2021-11-26
"PCientificoAlic","Erumgroup",1,0,0,1,2021-11-26
"PCientificoAlic","GVAavi",1,0,0,1,2021-11-26
"PCientificoAlic","PCientificoAlic",1,0,0,1,2021-11-26
"PCT_UCN","AIDIMME",1,0,0,1,2021-11-26
"PCT_UCN","AIJU_Tecnologi",1,0,0,1,2021-11-26
"PCT_UCN","aimplas",1,0,0,1,2021-11-26
"PCT_UCN","ainiatecnologia",1,0,0,1,2021-11-26
"PCT_UCN","GVAeconomia",1,0,0,1,2021-11-26
"PCT_UCN","ITC_ceramica",1,0,0,1,2021-11-26
"PCT_UCN","itene",1,0,0,1,2021-11-26
"PCT_UCN","itenergia",1,0,0,1,2021-11-26
"PCT_UCN","Julia_company",1,0,0,1,2021-11-26
"PCT_UCN","Rafa_Climentg",1,0,0,1,2021-11-26
"PCT_UCN","Redit_es",1,0,0,1,2021-11-26
"PCT_UCN","UCNorte",1,0,0,1,2021-11-26
"pedrojcarrillo","Agenda2030Gob",1,0,0,1,2021-11-26
"pedrojcarrillo","aimplas",1,0,0,1,2021-11-26
"pedrojcarrillo","IndustryTalksES",1,0,0,1,2021-11-26
"pedrojcarrillo","SustainableInnE",1,0,0,1,2021-11-26
"PerkinElmer","aimplas",1,0,0,1,2021-11-26
"pharmamarket","ibv_org",1,0,0,1,2021-11-26
"pharmamarket","taygclinic",1,0,0,1,2021-11-26
"pHjools","aimplas",1,0,0,1,2021-11-26
"pHjools","corifyAF",1,0,0,1,2021-11-26
"pHjools","EIT_Health_es",1,0,0,1,2021-11-26
"pHjools","Grupo_TSK",1,0,0,1,2021-11-26
"pHjools","Molecor",1,0,0,1,2021-11-26
"pHjools","PigCHAMP_Europa",1,0,0,1,2021-11-26
"pHjools","PlatinoEduca",1,0,0,1,2021-11-26
"pHjools","skrollerbelt",1,0,0,1,2021-11-26
"pickpackexpo","aimplas",1,0,0,1,2021-11-26
"PilMontana","aimplas",1,0,0,1,2021-11-26
"PilMontana","BASF_ES",1,0,0,1,2021-11-26
"PilMontana","deborahciencia",1,0,0,1,2021-11-26
"PilMontana","Repsol",1,0,0,1,2021-11-26
"PilMontana","SABIC",1,0,0,1,2021-11-26
"PilotHarbour","aivp_net",1,0,0,1,2021-11-26
"PilotHarbour","AjuntamentVLC",1,0,0,1,2021-11-26
"PilotHarbour","AsnavieraVlc",1,0,0,1,2021-11-26
"PilotHarbour","ESPOSecretariat",1,0,0,1,2021-11-26
"PilotHarbour","IMOHQ",1,0,0,1,2021-11-26
"PilotHarbour","propellervlc",1,0,0,1,2021-11-26
"PilotHarbour","PuertosEstado",1,0,0,1,2021-11-26
"Pinfa_EU","aimplas",1,0,0,1,2021-11-26
"plastic_museum","esplasticos",1,0,0,1,2021-11-26
"PlasticFV","GVAivace",1,0,0,1,2021-11-26
"PlasticFV","industriQuimica",1,0,0,1,2021-11-26
"PlasticFV","int_quimica",1,0,0,1,2021-11-26
"PlasticFV","UPV",1,0,0,1,2021-11-26
"PlasticFV","UV_EG",1,0,0,1,2021-11-26
"Plastico_Indl","VTTFinland",1,0,0,1,2021-11-26
"plasticomty","aimplas",1,0,0,1,2021-11-26
"plasticoshita","ANAIP_es",0,1,0,1,2021-11-26
"plasticoshita","ANARPLA",1,0,0,1,2021-11-26
"plasticoshita","AvepAsociacion",1,0,0,1,2021-11-26
"plasticoshita","Cicloplast_com",1,0,0,1,2021-11-26
"plasticoshita","esplasticos",1,0,0,1,2021-11-26
"plasticoshita","plastic_museum",1,0,0,1,2021-11-26
"plasticoshita","PlasticsEurope",1,0,0,1,2021-11-26
"PlasticsEuropES","AceiteOlivalle",1,0,0,1,2021-11-26
"PlasticsEuropES","ainiatecnologia",1,0,0,1,2021-11-26
"PlasticsEuropES","esplasticos",1,0,0,1,2021-11-26
"PlasticsEuropES","plastic_museum",1,0,0,1,2021-11-26
"PlasticsEuropES","shackletongroup",0,1,0,1,2021-11-26
"PlasticsEuropES","SusChemSpain",1,0,0,1,2021-11-26
"PlasticsWorld","Benihort",1,0,0,1,2021-11-26
"PlasticsWorld","RecyclersEU",1,0,0,1,2021-11-26
"PlatinoEduca","aimplas",1,0,0,1,2021-11-26
"PlatinoEduca","corifyAF",1,0,0,1,2021-11-26
"PlatinoEduca","Grupo_TSK",1,0,0,1,2021-11-26
"PlatinoEduca","Molecor",1,0,0,1,2021-11-26
"PlatinoEduca","PigCHAMP_Europa",1,0,0,1,2021-11-26
"PlatinoEduca","skrollerbelt",1,0,0,1,2021-11-26
"plazaradio_","aimplas",1,0,0,1,2021-11-26
"plazaradio_","RafaLupion",1,0,0,1,2021-11-26
"PMLEnergy","aimplas",1,0,0,1,2021-11-26
"PMLEnergy","itenergia",1,0,0,1,2021-11-26
"poscosecha","Benihort",1,0,0,1,2021-11-26
"poscosecha","CSIC",1,0,0,1,2021-11-26
"poscosecha","GVAavi",1,0,0,1,2021-11-26
"poscosecha","IBMCP",1,0,0,1,2021-11-26
"poscosecha","ITC_Packaging",1,0,0,1,2021-11-26
"poscosecha","UPV",1,0,0,1,2021-11-26
"prceinos","aimplas",1,0,0,1,2021-11-26
"prceinos","BIOVAL_es",1,0,0,1,2021-11-26
"prceinos","ceei",1,0,0,1,2021-11-26
"prceinos","ceeivalencia",1,0,0,1,2021-11-26
"prceinos","emprenemjunts",1,0,0,1,2021-11-26
"prceinos","GVAeconomia",1,0,0,1,2021-11-26
"prceinos","itenergia",1,0,0,1,2021-11-26
"PRS_Europe","aimplas",1,0,0,1,2021-11-26
"PT3NEO","aitex_es",1,0,0,1,2021-11-26
"PT3NEO","CienciaGob",1,0,0,1,2021-11-26
"PT3NEO","Eurecat_news",1,0,0,1,2021-11-26
"PT3NEO","fenin_es",1,0,0,1,2021-11-26
"PT3NEO","itene",1,0,0,1,2021-11-26
"PT3NEO","Naitec_CT",1,0,0,1,2021-11-26
"PT3NEO","NanomedSpain",1,0,0,1,2021-11-26
"PT3NEO","PT3NEO",1,0,0,1,2021-11-26
"PT3NEO","tecnalia",1,0,0,1,2021-11-26
"PT3NEO","UNavarra",1,0,0,1,2021-11-26
"PT3NEO","Zabala_IC",1,0,0,1,2021-11-26
"pteco2","funditec",1,0,0,1,2021-11-26
"pteco2","Inerco_",1,0,0,1,2021-11-26
"pteco2","Repsol",1,0,0,1,2021-11-26
"pteco2","SinCeO2",1,0,0,1,2021-11-26
"pteco2","unizar",1,0,0,1,2021-11-26
"QUIMACOVA","aimplas",1,0,0,1,2021-11-26
"QUIMACOVA","camaravalencia",1,0,0,1,2021-11-26
"QUIMACOVA","CDTIoficial",1,0,0,1,2021-11-26
"QUIMACOVA","Cleanity_es",1,0,0,1,2021-11-26
"QUIMACOVA","GVAavi",1,0,0,1,2021-11-26
"QUIMACOVA","GVAivace",1,0,0,1,2021-11-26
"QUIMACOVA","Redit_es",1,0,0,1,2021-11-26
"RachelRock2","aimplas",1,0,0,1,2021-11-26
"RachelRock2","GVAlabora",1,0,0,1,2021-11-26
"RamnBertNavarro","aimplas",1,0,0,1,2021-11-26
"RamnBertNavarro","Betelgeux_es",1,0,0,1,2021-11-26
"RamnBertNavarro","GVAavi",1,0,0,1,2021-11-26
"RamnBertNavarro","HospitalLaFe",1,0,0,1,2021-11-26
"RamnBertNavarro","ITQ_UPVCSIC",1,0,0,1,2021-11-26
"RamSG20","aimplas",1,0,0,1,2021-11-26
"RamSG20","Betelgeux_es",1,0,0,1,2021-11-26
"RamSG20","GVAavi",1,0,0,1,2021-11-26
"RamSG20","HospitalLaFe",1,0,0,1,2021-11-26
"RamSG20","ITQ_UPVCSIC",1,0,0,1,2021-11-26
"raorsamaq","aimplas",1,0,0,1,2021-11-26
"raorsamaq","Cicloplast_com",1,0,0,1,2021-11-26
"rappicupons105","aimplas",1,0,0,1,2021-11-26
"raqandu","aimplas",1,0,0,1,2021-11-26
"RececoEs","aimplas",1,0,0,1,2021-11-26
"RececoEs","esplasticos",1,0,0,1,2021-11-26
"RececoEs","IndustryTalksES",1,0,0,1,2021-11-26
"reciclajeFER","Aliciagfranco",1,0,0,1,2021-11-26
"reciclajeFER","AvepAsociacion",1,0,0,1,2021-11-26
"reciclajeFER","Cicloplast_com",1,0,0,1,2021-11-26
"RECOTRANS_H2020","AEMAC_",1,0,0,1,2021-11-26
"RECOTRANS_H2020","Arkema_group",1,0,0,1,2021-11-26
"RECOTRANS_H2020","Fraunhofer",1,0,0,1,2021-11-26
"Recuwaste","aimplas",1,0,0,1,2021-11-26
"Recuwaste","BASF_ES",1,0,0,1,2021-11-26
"Recuwaste","Petstarmx",1,0,0,1,2021-11-26
"Redit_es","3DPrinting_Des",1,0,0,1,2021-11-26
"Redit_es","Actecosl",1,0,0,1,2021-11-26
"Redit_es","Airbus",1,0,0,1,2021-11-26
"Redit_es","AjuntCastello",1,0,0,1,2021-11-26
"Redit_es","AMITMu_Val",1,0,0,1,2021-11-26
"Redit_es","ANAIP_es",1,0,0,1,2021-11-26
"Redit_es","AseTUB",1,0,0,1,2021-11-26
"Redit_es","asociacionruvid",1,0,0,1,2021-11-26
"Redit_es","AvepAsociacion",1,0,0,1,2021-11-26
"Redit_es","Baliht_EU",1,0,0,1,2021-11-26
"Redit_es","Bego_Pe",1,0,0,1,2021-11-26
"Redit_es","biofabrik",1,0,0,1,2021-11-26
"Redit_es","bioinicia",1,0,0,1,2021-11-26
"Redit_es","BIOnTop_Project",1,0,0,1,2021-11-26
"Redit_es","BIOVAL_es",1,0,0,1,2021-11-26
"Redit_es","Cajamar",1,0,0,1,2021-11-26
"Redit_es","CdeCarnica",1,0,0,1,2021-11-26
"Redit_es","CEPESCA",1,0,0,1,2021-11-26
"Redit_es","Cicloplast_com",1,0,0,1,2021-11-26
"Redit_es","ClusterFPrint",1,0,0,1,2021-11-26
"Redit_es","Colquimva",1,0,0,1,2021-11-26
"Redit_es","copecastellon",0,1,0,1,2021-11-26
"Redit_es","CORDIS_EU",1,0,0,1,2021-11-26
"Redit_es","CSICval",1,0,0,1,2021-11-26
"Redit_es","ed_cvalenciana",1,0,0,1,2021-11-26
"Redit_es","EuMarenco",1,0,0,1,2021-11-26
"Redit_es","Faurecia",1,0,0,1,2021-11-26
"Redit_es","FConexus",1,0,0,1,2021-11-26
"Redit_es","Fedit",1,0,0,1,2021-11-26
"Redit_es","fenin_es",1,0,0,1,2021-11-26
"Redit_es","Fira_Barcelona",1,0,0,1,2021-11-26
"Redit_es","Fritta_slu",1,0,0,1,2021-11-26
"Redit_es","gbelenguer",1,0,0,1,2021-11-26
"Redit_es","GreenTurf",1,0,0,1,2021-11-26
"Redit_es","GVAddigital",1,0,0,1,2021-11-26
"Redit_es","horizonte2020",1,0,0,1,2021-11-26
"Redit_es","iberapa",1,0,0,1,2021-11-26
"Redit_es","IMDEAInstitutes",1,0,0,1,2021-11-26
"Redit_es","IzasaScientific",1,0,0,1,2021-11-26
"Redit_es","jordi_juan",1,0,0,1,2021-11-26
"Redit_es","KerabenGrupo",1,0,0,1,2021-11-26
"Redit_es","KITKarlsruhe",1,0,0,1,2021-11-26
"Redit_es","LaFabricaDRadio",1,0,0,1,2021-11-26
"Redit_es","LafargeHolcimES",1,0,0,1,2021-11-26
"Redit_es","laprimerapiedra",1,0,0,1,2021-11-26
"Redit_es","levante_emv",1,0,0,1,2021-11-26
"Redit_es","NanomedSpain",1,0,0,1,2021-11-26
"Redit_es","Nestle_es",1,0,0,1,2021-11-26
"Redit_es","OceanetsProject",1,0,0,1,2021-11-26
"Redit_es","PacoCremades",1,0,0,1,2021-11-26
"Redit_es","Porcelanosa_es",1,0,0,1,2021-11-26
"Redit_es","prolabintefarm",1,0,0,1,2021-11-26
"Redit_es","PT3NEO",1,0,0,1,2021-11-26
"Redit_es","PTEPA1",1,0,0,1,2021-11-26
"Redit_es","ptprotecma",1,0,0,1,2021-11-26
"Redit_es","realturfoficial",1,0,0,1,2021-11-26
"Redit_es","ReciclaliaC",1,0,0,1,2021-11-26
"Redit_es","RecyclersEU",1,0,0,1,2021-11-26
"Redit_es","ReportsMarkets",1,0,0,1,2021-11-26
"Redit_es","RevistaRETEMA",1,0,0,1,2021-11-26
"Redit_es","seimedcv",1,0,0,1,2021-11-26
"Redit_es","sofitec_",1,0,0,1,2021-11-26
"Redit_es","Startup_VLC",1,0,0,1,2021-11-26
"Redit_es","tecnoalimen",1,0,0,1,2021-11-26
"Redit_es","UV_EG",1,0,0,1,2021-11-26
"REGEMAT3D","aimplas",1,0,0,1,2021-11-26
"Regmurcialimpia","ACCIONA",1,0,0,1,2021-11-26
"Regmurcialimpia","AerzenIberica",1,0,0,1,2021-11-26
"Regmurcialimpia","AlmarWater",1,0,0,1,2021-11-26
"Regmurcialimpia","AmbientalRM",1,0,0,1,2021-11-26
"Regmurcialimpia","ambienteeuropeo",0,1,0,1,2021-11-26
"Regmurcialimpia","asegre01",1,0,0,1,2021-11-26
"Regmurcialimpia","ASEMUPLAST",1,0,0,1,2021-11-26
"Regmurcialimpia","BASF_ES",1,0,0,1,2021-11-26
"Regmurcialimpia","CarmenFructuos4",1,0,0,1,2021-11-26
"Regmurcialimpia","CETAQUA",1,0,0,1,2021-11-26
"Regmurcialimpia","FCC_MA",1,0,0,1,2021-11-26
"Regmurcialimpia","FidelLopezSoria",1,0,0,1,2021-11-26
"Regmurcialimpia","gremirecupera",1,0,0,1,2021-11-26
"Regmurcialimpia","picvisa",1,0,0,1,2021-11-26
"Regmurcialimpia","recyclia",1,0,0,1,2021-11-26
"Regmurcialimpia","Repsol",1,0,0,1,2021-11-26
"Regmurcialimpia","SogamaXunta",1,0,0,1,2021-11-26
"Regmurcialimpia","SostenEconomica",1,0,0,1,2021-11-26
"Regmurcialimpia","suezES",1,0,0,1,2021-11-26
"Regmurcialimpia","TOMRARecycling",1,0,0,1,2021-11-26
"Regmurcialimpia","VeoliaWaterTech",1,0,0,1,2021-11-26
"REMADYL_EU","Circ_Flooring",1,0,0,1,2021-11-26
"REMADYL_EU","ENCOsrl",1,0,0,1,2021-11-26
"REMADYL_EU","EU_Commission",1,0,0,1,2021-11-26
"REMADYL_EU","EU_ecoinno",1,0,0,1,2021-11-26
"REMADYL_EU","EU_H2020",1,0,0,1,2021-11-26
"REMADYL_EU","FraunhoferICT",1,0,0,1,2021-11-26
"REMADYL_EU","ICMol_UV",1,0,0,1,2021-11-26
"REMADYL_EU","NanoMatFraunho1",1,0,0,1,2021-11-26
"REMADYL_EU","OVAM_Ecodesign",1,0,0,1,2021-11-26
"REMADYL_EU","project_react",1,0,0,1,2021-11-26
"REMADYL_EU","Promolding",1,0,0,1,2021-11-26
"REMADYL_EU","Vertech_Group",1,0,0,1,2021-11-26
"RepetCoinnova","esplasticos",1,0,0,1,2021-11-26
"residuorecurso","aimplas",1,0,0,1,2021-11-26
"ResiduosPro","AIDIMME",1,0,0,1,2021-11-26
"ResiduosPro","Cicloplast_com",1,0,0,1,2021-11-26
"ResiduosPro","GVAivace",1,0,0,1,2021-11-26
"ResiduosPro","InescopTech",1,0,0,1,2021-11-26
"ResiduosPro","ITC_ceramica",1,0,0,1,2021-11-26
"ResiduosPro","UV_EG",1,0,0,1,2021-11-26
"reverdeconcausa","aimplas",1,0,0,1,2021-11-26
"reverdeconcausa","canalsur",1,0,0,1,2021-11-26
"reverdeconcausa","ensgismau",1,0,0,1,2021-11-26
"reverdeconcausa","manavas21",1,0,0,1,2021-11-26
"reverdeconcausa","vir_montero",1,0,0,1,2021-11-26
"revista_PQ","ANAIP_es",1,0,0,1,2021-11-26
"revista_PQ","BactiBlock",1,0,0,1,2021-11-26
"revista_PQ","Cicloplast_com",1,0,0,1,2021-11-26
"revista_PQ","ENAC_acredita",1,0,0,1,2021-11-26
"revista_PQ","esplasticos",1,0,0,1,2021-11-26
"revista_PQ","Microban",1,0,0,1,2021-11-26
"revista_PQ","pharmamarket",1,0,0,1,2021-11-26
"revistaide","ainiatecnologia",1,0,0,1,2021-11-26
"revistaide","ANAIP_es",1,0,0,1,2021-11-26
"revistaide","ANARPLA",1,0,0,1,2021-11-26
"revistaide","AvepAsociacion",1,0,0,1,2021-11-26
"revistaide","PlasticsEuropES",1,0,0,1,2021-11-26
"revistaimcb","itenergia",1,0,0,1,2021-11-26
"RevistaMercados","ACES_supers",1,0,0,1,2021-11-26
"RevistaMercados","AECOC_ES",1,0,0,1,2021-11-26
"RevistaMercados","alcampo",1,0,0,1,2021-11-26
"RevistaMercados","AvepAsociacion",1,0,0,1,2021-11-26
"RevistaMercados","Benihort",1,0,0,1,2021-11-26
"RevistaMercados","Cicloplast_com",1,0,0,1,2021-11-26
"RevistaMercados","COEXPAN_",1,0,0,1,2021-11-26
"RevistaMercados","CoopsAgroCV",1,0,0,1,2021-11-26
"RevistaMercados","danone_es",1,0,0,1,2021-11-26
"RevistaMercados","Ecovalia",1,0,0,1,2021-11-26
"RevistaMercados","FEPEX_EU",1,0,0,1,2021-11-26
"RevistaMercados","PlasticsEuropES",1,0,0,1,2021-11-26
"RevistaRETEMA","AIDIMME",1,0,0,1,2021-11-26
"RevistaRETEMA","ainiatecnologia",1,0,0,1,2021-11-26
"RevistaRETEMA","ANAIP_es",1,0,0,1,2021-11-26
"RevistaRETEMA","AvepAsociacion",1,0,0,1,2021-11-26
"RevistaRETEMA","CIDETEC_",1,0,0,1,2021-11-26
"RevistaRETEMA","itenergia",1,0,0,1,2021-11-26
"RevistaRETEMA","PlasticsEuropES",1,0,0,1,2021-11-26
"RevistaRETEMA","recotrans",1,0,0,1,2021-11-26
"RevistaRETEMA","TOMRARecycling",1,0,0,1,2021-11-26
"RevistaRETEMA","UV_EG",1,0,0,1,2021-11-26
"rosamontesa","aimplas",1,0,0,1,2021-11-26
"rotoatlantica","aimplas",1,0,0,1,2021-11-26
"rotoatlantica","GVAivace",1,0,0,1,2021-11-26
"RPM_Plasticos","ANARPLA",1,0,0,1,2021-11-26
"RPM_Plasticos","BASF",1,0,0,1,2021-11-26
"RPM_Plasticos","Cicloplast_com",1,0,0,1,2021-11-26
"RPM_Plasticos","Colquimva",1,0,0,1,2021-11-26
"RPM_Plasticos","ITC_ceramica",1,0,0,1,2021-11-26
"RPM_Plasticos","PlasticsEurope",1,0,0,1,2021-11-26
"RPM_Plasticos","Repsol",1,0,0,1,2021-11-26
"RPM_Plasticos","SABIC",1,0,0,1,2021-11-26
"RSM_es","agrodhuelva",1,0,0,1,2021-11-26
"RSM_es","Alimarket",1,0,0,1,2021-11-26
"RSM_es","Tecnobebidas",1,0,0,1,2021-11-26
"RTVEValencia","AdrianaPrados",1,0,0,1,2021-11-26
"RTVEValencia","aimplas",1,0,0,1,2021-11-26
"RTVEValencia","GVAinnova",1,0,0,1,2021-11-26
"ruralpedia","AceiteOlivalle",1,0,0,1,2021-11-26
"ruralpedia","aimplas",1,0,0,1,2021-11-26
"sabadellprensa","aimplas",1,0,0,1,2021-11-26
"sabadellprensa","BancoSabadell",1,0,0,1,2021-11-26
"sabadellprensa","Grupo_Soledad",1,0,0,1,2021-11-26
"sabadellprensa","istobal_es",1,0,0,1,2021-11-26
"sabadellprensa","levante_emv",1,0,0,1,2021-11-26
"SagredoMarco","DarwinBioprosp",1,0,0,1,2021-11-26
"SagredoMarco","InescopTech",1,0,0,1,2021-11-26
"SagredoMarco","ITC_ceramica",1,0,0,1,2021-11-26
"SagredoMarco","SagredoMarco",0,0,1,1,2021-11-26
"Saludes_Ind","aimplas",1,0,0,1,2021-11-26
"Saludes_Ind","ibv_org",1,0,0,1,2021-11-26
"Saludes_Ind","LaPinadaLab",1,0,0,1,2021-11-26
"Saludes_Ind","uchceu",1,0,0,1,2021-11-26
"Saludes_Ind","UPV",1,0,0,1,2021-11-26
"Saludes_Ind","WDCValencia2022",1,0,0,1,2021-11-26
"saludes_play","aimplas",1,0,0,1,2021-11-26
"saludes_play","GVAivace",1,0,0,1,2021-11-26
"saludes_play","itenergia",1,0,0,1,2021-11-26
"Sam_felix","AIDIMME",1,0,0,1,2021-11-26
"Sam_felix","aimplas",1,0,0,1,2021-11-26
"Sam_felix","Avia_automocion",1,0,0,1,2021-11-26
"Sam_felix","HP",1,0,0,1,2021-11-26
"Sam_felix","sernauto",1,0,0,1,2021-11-26
"Santa_Teresa","aimplas",1,0,0,1,2021-11-26
"Santa_Teresa","FGULEM",1,0,0,1,2021-11-26
"Santa_Teresa","fgusal",1,0,0,1,2021-11-26
"Santa_Teresa","Fundacion_CTME",1,0,0,1,2021-11-26
"Santa_Teresa","FundacionUBU",1,0,0,1,2021-11-26
"Santa_Teresa","fungeuva",1,0,0,1,2021-11-26
"Santa_Teresa","Santa_Teresa",1,0,0,1,2021-11-26
"sapiensenergia","aimplas",1,0,0,1,2021-11-26
"sapiensenergia","GVAivace",1,0,0,1,2021-11-26
"sapiensenergia","itenergia",1,0,0,1,2021-11-26
"SDDR_info","aimplas",1,0,0,1,2021-11-26
"SDDR_info","ANARPLA",1,0,0,1,2021-11-26
"SDDR_info","Cicloplast_com",1,0,0,1,2021-11-26
"SDDR_info","cogersaasturias",1,0,0,1,2021-11-26
"SDDR_info","cogersacatedra",1,0,0,1,2021-11-26
"SDDR_info","DriadeSM",1,0,0,1,2021-11-26
"SDDR_info","gremirecupera",1,0,0,1,2021-11-26
"SDDR_info","mitecogob",1,0,0,1,2021-11-26
"SDDR_info","residuscat",1,0,0,1,2021-11-26
"SDDR_info","SDDR_info",0,1,0,1,2021-11-26
"SDDR_info","SogamaXunta",1,0,0,1,2021-11-26
"SDDR_info","Vertidos_Cero",1,0,0,1,2021-11-26
"segacases","aimplas",1,0,0,1,2021-11-26
"segacases","AvepAsociacion",1,0,0,1,2021-11-26
"segacases","GrupoGPS_sefh",1,0,0,1,2021-11-26
"segacases","micofvlc",1,0,0,1,2021-11-26
"seimedcv","aimplas",1,0,0,1,2021-11-26
"seimedcv","CentrosCex",0,1,0,1,2021-11-26
"seimedcv","GVAivace",1,0,0,1,2021-11-26
"seimedcv","Redit_es",1,0,0,1,2021-11-26
"SemanaRSC","aimplas",1,0,0,1,2021-11-26
"SemanaRSC","Apambu_",1,0,0,1,2021-11-26
"SemanaRSC","AsisaSalud",1,0,0,1,2021-11-26
"SemanaRSC","BSABadalona",1,0,0,1,2021-11-26
"SemanaRSC","crearsa",1,0,0,1,2021-11-26
"SemanaRSC","Desconnexions",1,0,0,1,2021-11-26
"SemanaRSC","Expok",1,0,0,1,2021-11-26
"SemanaRSC","FELGTB",1,0,0,1,2021-11-26
"SemanaRSC","gngroup",1,0,0,1,2021-11-26
"SemanaRSC","hiltondiagonal",1,0,0,1,2021-11-26
"SemanaRSC","KLM_ES",1,0,0,1,2021-11-26
"SemanaRSC","LaCalaixera",1,0,0,1,2021-11-26
"SemanaRSC","omplim",1,0,0,1,2021-11-26
"SemanaRSC","tossalloficial",1,0,0,1,2021-11-26
"SENA_RValle","Acoplasticos",1,0,0,1,2021-11-26
"SENA_RValle","aimplas",1,0,0,1,2021-11-26
"SENA_RValle","lauao",1,0,0,1,2021-11-26
"SENA_RValle","UnivalleCol",1,0,0,1,2021-11-26
"silviaavilesg","AdvanFactories",1,0,0,1,2021-11-26
"silviaavilesg","AEMAC_",1,0,0,1,2021-11-26
"silviaavilesg","Airbus",1,0,0,1,2021-11-26
"silviaavilesg","ANAIP_es",1,0,0,1,2021-11-26
"silviaavilesg","CDTIoficial",1,0,0,1,2021-11-26
"silviaavilesg","DANOBATGROUP",1,0,0,1,2021-11-26
"silviaavilesg","Redit_es",1,0,0,1,2021-11-26
"silviaavilesg","TalgoGroup",1,0,0,1,2021-11-26
"silviaavilesg","UdGPolitecnica",1,0,0,1,2021-11-26
"skrollerbelt","aimplas",1,0,0,1,2021-11-26
"skrollerbelt","corifyAF",1,0,0,1,2021-11-26
"skrollerbelt","Grupo_TSK",1,0,0,1,2021-11-26
"skrollerbelt","Molecor",1,0,0,1,2021-11-26
"skrollerbelt","PigCHAMP_Europa",1,0,0,1,2021-11-26
"skrollerbelt","PlatinoEduca",1,0,0,1,2021-11-26
"SoniaHe49592177","aimplas",1,0,0,1,2021-11-26
"SoniaHe49592177","Betelgeux_es",1,0,0,1,2021-11-26
"SoniaHe49592177","GVAavi",1,0,0,1,2021-11-26
"SoniaHe49592177","HospitalLaFe",1,0,0,1,2021-11-26
"SoniaHe49592177","ITQ_UPVCSIC",1,0,0,1,2021-11-26
"SoniTirado","generalitat",1,0,0,1,2021-11-26
"SpainBiz_Japan","aimplas",1,0,0,1,2021-11-26
"SpainBiz_Japan","BlueplasmaPower",1,0,0,1,2021-11-26
"SphereSpain","aimplas",1,0,0,1,2021-11-26
"SphereSpain","ANAIP_es",1,0,0,1,2021-11-26
"SphereSpain","esplasticos",1,0,0,1,2021-11-26
"ssuchy_eu","aimplas",1,0,0,1,2021-11-26
"ssuchy_eu","cleansky_ju",1,0,0,1,2021-11-26
"ssuchy_eu","JECComposites",0,1,0,1,2021-11-26
"ssuchy_eu","TNO_Research",1,0,0,1,2021-11-26
"Startup_VLC","aganovagrupo",1,0,0,1,2021-11-26
"Startup_VLC","aimplas",1,0,0,1,2021-11-26
"Startup_VLC","angelramire",1,0,0,1,2021-11-26
"Startup_VLC","EosOrbital",1,0,0,1,2021-11-26
"Startup_VLC","GlobalOmnium",1,0,0,1,2021-11-26
"Startup_VLC","GoHubTech",1,0,0,1,2021-11-26
"Startup_VLC","JuanPeaIbaez2",1,0,0,1,2021-11-26
"Startup_VLC","LinkenerSpain",1,0,0,1,2021-11-26
"Startup_VLC","pepesiega",1,0,0,1,2021-11-26
"SusanaPBadal","aimplas",1,0,0,1,2021-11-26
"SusanaPBadal","GVAavi",1,0,0,1,2021-11-26
"SusanaPBadal","ITC_Packaging",1,0,0,1,2021-11-26
"SusanaPBadal","marsanpa",1,0,0,1,2021-11-26
"SusChemSpain","Airbus",1,0,0,1,2021-11-26
"SusChemSpain","Cefic",1,0,0,1,2021-11-26
"SusChemSpain","foretica",1,0,0,1,2021-11-26
"SusChemSpain","omenendez",1,0,0,1,2021-11-26
"SusChemSpain","Pascual",1,0,0,1,2021-11-26
"SusChemSpain","SusChemSpain",1,0,0,1,2021-11-26
"SusChemSpain","ternua",1,0,0,1,2021-11-26
"SUST4IN","aimplas",1,0,0,1,2021-11-26
"SUST4IN","FuturEnviro",1,0,0,1,2021-11-26
"SustainPlastics","kpGroup_",1,0,0,1,2021-11-26
"tabitbilisim","aimplas",1,0,0,1,2021-11-26
"tabitbilisim","azmud",1,0,0,1,2021-11-26
"tabitbilisim","idainature",1,0,0,1,2021-11-26
"tabitbilisim","prima",1,0,0,1,2021-11-26
"talk2much12","accio_cat",1,0,0,1,2021-11-26
"talk2much12","aimplas",1,0,0,1,2021-11-26
"talk2much12","AristosInfo",1,0,0,1,2021-11-26
"talk2much12","biocat_cat",1,0,0,1,2021-11-26
"talk2much12","CDTIoficial",1,0,0,1,2021-11-26
"talk2much12","eencat",1,0,0,1,2021-11-26
"talk2much12","Eurecat_news",1,0,0,1,2021-11-26
"talk2much12","horizonexperts",1,0,0,1,2021-11-26
"talk2much12","IreneLarroy",1,0,0,1,2021-11-26
"talk2much12","JCGarcia_CDTI",1,0,0,1,2021-11-26
"talk2much12","jordipietx",1,0,0,1,2021-11-26
"talk2much12","RosaAriasAlv",1,0,0,1,2021-11-26
"talk2much12","scibus",1,0,0,1,2021-11-26
"talk2much12","SorosGabinete",1,0,0,1,2021-11-26
"talk2much12","Wendy_Moreno_EU",1,0,0,1,2021-11-26
"tecnalia","AgEInves",1,0,0,1,2021-11-26
"tecnalia","aimplas",1,0,0,1,2021-11-26
"tecnalia","FunditecOrg",1,0,0,1,2021-11-26
"tecnalia","incarCSIC",1,0,0,1,2021-11-26
"tecnalia","tecnalia",1,0,0,1,2021-11-26
"tecnalia","ualmeria",1,0,0,1,2021-11-26
"Tecnifood","ANAIP_es",1,0,0,1,2021-11-26
"Tecnifood","Cicloplast_com",1,0,0,1,2021-11-26
"Tecnifood","danone_es",1,0,0,1,2021-11-26
"Tecnifood","esplasticos",1,0,0,1,2021-11-26
"Tecnifood","expoquimia",1,0,0,1,2021-11-26
"Tecnifood","faerchgroup",1,0,0,1,2021-11-26
"Tecnifood","GVAivace",1,0,0,1,2021-11-26
"Tecnifood","ITI_TIC",1,0,0,1,2021-11-26
"Tecnifood","Nestle_es",1,0,0,1,2021-11-26
"Tecnifood","Penn",1,0,0,1,2021-11-26
"Tecnifood","PlasticsEuropES",1,0,0,1,2021-11-26
"Tecnifood","Tecnifood",1,0,0,1,2021-11-26
"Tecnifood","UNALOficial",1,0,0,1,2021-11-26
"tecnoaqua","aimplas",1,0,0,1,2021-11-26
"tecnopackaging","aacudam",1,0,0,1,2021-11-26
"tecnopackaging","AgroBioCluster",1,0,0,1,2021-11-26
"tecnopackaging","aimplas",1,0,0,1,2021-11-26
"tecnopackaging","CIDETEC_",1,0,0,1,2021-11-26
"tecnopackaging","FarrellyMitchel",1,0,0,1,2021-11-26
"tecnopackaging","GenHydro",1,0,0,1,2021-11-26
"tecnopackaging","GreenovateEU",1,0,0,1,2021-11-26
"tecnopackaging","mi_sustainable",1,0,0,1,2021-11-26
"tecnopackaging","RISEProcessum",1,0,0,1,2021-11-26
"tecnopackaging","tecnopackaging",0,0,1,1,2021-11-26
"TeknikerOficial","20m",1,0,0,1,2021-11-26
"TeknikerOficial","aimplas",1,0,0,1,2021-11-26
"ter4bithi4","BASF_ES",1,0,0,1,2021-11-26
"ter4bithi4","CDTIoficial",1,0,0,1,2021-11-26
"ter4bithi4","Cefic",1,0,0,1,2021-11-26
"ter4bithi4","deborahciencia",1,0,0,1,2021-11-26
"ter4bithi4","EsAirbus",1,0,0,1,2021-11-26
"ter4bithi4","EsHorizonte2020",1,0,0,1,2021-11-26
"ter4bithi4","Feique_ES",1,0,0,1,2021-11-26
"ter4bithi4","foretica",1,0,0,1,2021-11-26
"ter4bithi4","omenendez",1,0,0,1,2021-11-26
"ter4bithi4","Pascual",1,0,0,1,2021-11-26
"ter4bithi4","Repsol",1,0,0,1,2021-11-26
"ter4bithi4","SABIC",1,0,0,1,2021-11-26
"ter4bithi4","SusChemSpain",1,0,0,1,2021-11-26
"ter4bithi4","ter4bithi4",0,0,1,1,2021-11-26
"ter4bithi4","ternua",1,0,0,1,2021-11-26
"terenet","aimplas",1,0,0,1,2021-11-26
"terenet","artsolut",1,0,0,1,2021-11-26
"terenet","dipMurcia",1,0,0,1,2021-11-26
"terenet","EssentraPackES",1,0,0,1,2021-11-26
"terenet","Foro_READ",1,0,0,1,2021-11-26
"terenet","itene",1,0,0,1,2021-11-26
"TeximInfo","addimat",1,0,0,1,2021-11-26
"TeximInfo","AvepAsociacion",1,0,0,1,2021-11-26
"TeximInfo","ibv_org",1,0,0,1,2021-11-26
"TeximInfo","TechExcelencia",1,0,0,1,2021-11-26
"TheCircularLab","aimplas",1,0,0,1,2021-11-26
"TheCircularLab","ecoticiasRED",1,0,0,1,2021-11-26
"TheCircularLab","GVAivace",1,0,0,1,2021-11-26
"TifasGalicia","aimplas",1,0,0,1,2021-11-26
"TifasGalicia","GVAivace",1,0,0,1,2021-11-26
"Titania_aero","aimplas",1,0,0,1,2021-11-26
"Titania_aero","CTengineers",1,0,0,1,2021-11-26
"Titania_aero","Inespasa_",1,0,0,1,2021-11-26
"TitoCrissien","TitoCrissien",0,0,1,1,2021-11-26
"TRAKTECH_","ainiatecnologia",1,0,0,1,2021-11-26
"TRAKTECH_","ANAIP_es",1,0,0,1,2021-11-26
"TRAKTECH_","ANARPLA",1,0,0,1,2021-11-26
"TRAKTECH_","Cicloplast_com",1,0,0,1,2021-11-26
"TRAKTECH_","expoquimia",1,0,0,1,2021-11-26
"TRAKTECH_","gremirecupera",1,0,0,1,2021-11-26
"TRAKTECH_","LAB_Ecoinnova",1,0,0,1,2021-11-26
"TRAKTECH_","PlasticsEurope",1,0,0,1,2021-11-26
"TRAKTECH_","Suruscircular",1,0,0,1,2021-11-26
"ucvalencia","AIDIMME",1,0,0,1,2021-11-26
"ucvalencia","AIJU_Tecnologi",1,0,0,1,2021-11-26
"ucvalencia","aimplas",1,0,0,1,2021-11-26
"ucvalencia","ainiatecnologia",1,0,0,1,2021-11-26
"ucvalencia","aitex_es",1,0,0,1,2021-11-26
"ucvalencia","ibv_org",1,0,0,1,2021-11-26
"ucvalencia","InescopTech",1,0,0,1,2021-11-26
"ucvalencia","ITC_ceramica",1,0,0,1,2021-11-26
"ucvalencia","itene",1,0,0,1,2021-11-26
"ucvalencia","itenergia",1,0,0,1,2021-11-26
"ucvalencia","ITI_TIC",1,0,0,1,2021-11-26
"UniElectrica","aimplas",1,0,0,1,2021-11-26
"UNLOCK_BBI","aacudam",1,0,0,1,2021-11-26
"UNLOCK_BBI","AgroBioCluster",1,0,0,1,2021-11-26
"UNLOCK_BBI","CIDETEC_",1,0,0,1,2021-11-26
"UNLOCK_BBI","FarrellyMitchel",1,0,0,1,2021-11-26
"UNLOCK_BBI","GenHydro",1,0,0,1,2021-11-26
"UNLOCK_BBI","GreenovateEU",1,0,0,1,2021-11-26
"UNLOCK_BBI","mi_sustainable",1,0,0,1,2021-11-26
"UNLOCK_BBI","RISEProcessum",1,0,0,1,2021-11-26
"UNLOCK_BBI","tecnopackaging",1,0,0,1,2021-11-26
"UNLOCK_BBI","unlock",1,0,0,1,2021-11-26
"UPLIFT_EU","CristianoVarro2",1,0,0,1,2021-11-26
"UPLIFT_EU","Equiplast",1,0,0,1,2021-11-26
"UPLIFT_EU","EU_H2020",1,0,0,1,2021-11-26
"UPLIFT_EU","EU_HaDEA",1,0,0,1,2021-11-26
"UPLIFT_EU","fpffoundation",1,0,0,1,2021-11-26
"UPLIFT_EU","H2020GreenDeal",1,0,0,1,2021-11-26
"UPLIFT_EU","lapalmaresearch",1,0,0,1,2021-11-26
"UPLIFT_EU","MacaronightEU",1,0,0,1,2021-11-26
"UprofesValencia","aimplas",1,0,0,1,2021-11-26
"UprofesValencia","Colquimva",1,0,0,1,2021-11-26
"valenciactiva_","aimplas",1,0,0,1,2021-11-26
"valenciactiva_","valenciactiva_",0,0,1,1,2021-11-26
"VAtradu","aimplas",1,0,0,1,2021-11-26
"veredictas","alabrent_mag",1,0,0,1,2021-11-26
"veredictas","Albert_Margalef",1,0,0,1,2021-11-26
"veredictas","ESDi_Barcelona",1,0,0,1,2021-11-26
"veredictas","iptriana",1,0,0,1,2021-11-26
"veredictas","Kaitxo2017",1,0,0,1,2021-11-26
"veredictas","MauricioCarret6",1,0,0,1,2021-11-26
"Vermican","aimplas",1,0,0,1,2021-11-26
"Vermican","Benihort",1,0,0,1,2021-11-26
"Vermican","IBMCP",1,0,0,1,2021-11-26
"Vertidos_Cero","EstrellaDammCat",1,0,0,1,2021-11-26
"Vertidos_Cero","EstrellaDammEs",1,0,0,1,2021-11-26
"Vertidos_Cero","EU_MARE",0,1,0,1,2021-11-26
"Vertidos_Cero","MasMineria",1,0,0,1,2021-11-26
"Vertidos_Cero","prendente",1,0,0,1,2021-11-26
"Vertidos_Cero","rtve",1,0,0,1,2021-11-26
"VicenteAbella","aimplas",1,0,0,1,2021-11-26
"VicenteAbella","VAtradu",1,0,0,1,2021-11-26
"vincenzo_gente","EU_EASME",1,0,0,1,2021-11-26
"vincenzo_gente","EU_MARE",1,0,0,1,2021-11-26
"vincenzo_gente","OceanetsProject",1,0,0,1,2021-11-26
"VirtualWalcon","aimplas",1,0,0,1,2021-11-26
"VirtualWalcon","Cicloplast_com",1,0,0,1,2021-11-26
"VirtualWalcon","VirtualWalcon",1,0,0,1,2021-11-26
"VLCTechCity","AIDIMME",1,0,0,1,2021-11-26
"VLCTechCity","ainiatecnologia",1,0,0,1,2021-11-26
"VLCTechCity","belenfranchgras",1,0,0,1,2021-11-26
"VLCTechCity","cdcampo1",1,0,0,1,2021-11-26
"VLCTechCity","FGlobalNature",1,0,0,1,2021-11-26
"VLCTechCity","GVAivace",1,0,0,1,2021-11-26
"VLCTechCity","InescopTech",1,0,0,1,2021-11-26
"VLCTechCity","levante_emv",1,0,0,1,2021-11-26
"VLCTechCity","VLCTechCity",0,0,1,1,2021-11-26
"WaystupH2020","ETAM_SA",1,0,0,1,2021-11-26
"WaystupH2020","TerraiXufaRSSFA",1,0,0,1,2021-11-26
"WriterAlejandro","aimplas",1,0,0,1,2021-11-26
"WriterAlejandro","BBI2020",1,0,0,1,2021-11-26
"WriterAlejandro","biconsortium",1,0,0,1,2021-11-26
"WriterAlejandro","BioVale_Cluster",1,0,0,1,2021-11-26
"WriterAlejandro","BPF_pilotplant",1,0,0,1,2021-11-26
"WriterAlejandro","coopagrariesCAT",1,0,0,1,2021-11-26
"WriterAlejandro","EU_H2020",1,0,0,1,2021-11-26
"WriterAlejandro","InnoconsultLc",1,0,0,1,2021-11-26
"WriterAlejandro","iris_rd",1,0,0,1,2021-11-26
"WriterAlejandro","irtacat",1,0,0,1,2021-11-26
"WriterAlejandro","mogumycelium",1,0,0,1,2021-11-26
"WriterAlejandro","ualmeria",1,0,0,1,2021-11-26
"WriterAlejandro","UniboMagazine",1,0,0,1,2021-11-26
"xemagil","aimplas",1,0,0,1,2021-11-26
"xemagil","Arturolarena",1,0,0,1,2021-11-26
"xemagil","BelenFranch",1,0,0,1,2021-11-26
"ximogorriz","aimplas",1,0,0,1,2021-11-26
"ximogorriz","AndresGReche",1,0,0,1,2021-11-26
"ximogorriz","espaitec",1,0,0,1,2021-11-26
"ximogorriz","GVAavi",1,0,0,1,2021-11-26
"ximogorriz","jesus_lancis",1,0,0,1,2021-11-26
"ximogorriz","MosaikUrbanSys",1,0,0,1,2021-11-26
"ximogorriz","SchneiderES",1,0,0,1,2021-11-26
"ximogorriz","SGS_Spain",1,0,0,1,2021-11-26
"ximogorriz","UJIuniversitat",1,0,0,1,2021-11-26
"yudani_yudani","aimplas",1,0,0,1,2021-11-26
"yudani_yudani","ArviInnovapesca",1,0,0,1,2021-11-26
"yudani_yudani","CEPESCA",1,0,0,1,2021-11-26
"yudani_yudani","JJChicolino",1,0,0,1,2021-11-26
"yudani_yudani","MarineInstrumen",1,0,0,1,2021-11-26
"yudani_yudani","mitecogob",1,0,0,1,2021-11-26
"yudani_yudani","PTEPA1",1,0,0,1,2021-11-26
"yudani_yudani","ptprotecma",1,0,0,1,2021-11-26
"yudani_yudani","PuertoDeVigo",1,0,0,1,2021-11-26
"zicla_eus","aimplas",1,0,0,1,2021-11-26
"zicla_eus","InescopTech",1,0,0,1,2021-11-26
"zicla_eus","RevistaRETEMA",1,0,0,1,2021-11-26
"zoomtvcordoba","AceiteOlivalle",1,0,0,1,2021-11-26
"zoomtvcordoba","aimplas",1,0,0,1,2021-11-26
